"State","Year","Data.DHS Denominator","Data.Number of Firms","Data.Calculated.Net Job Creation","Data.Calculated.Net Job Creation Rate","Data.Calculated.Reallocation Rate","Data.Establishments.Entered","Data.Establishments.Entered Rate","Data.Establishments.Exited","Data.Establishments.Exited Rate","Data.Establishments.Physical Locations","Data.Firm Exits.Count","Data.Firm Exits.Establishment Exit","Data.Firm Exits.Job Destruction","Data.Job Creation.Births","Data.Job Creation.Continuers","Data.Job Creation.Count","Data.Job Creation.Rate","Data.Job Creation.Rate/Births","Data.Job Destruction.Continuers","Data.Job Destruction.Count","Data.Job Destruction.Deaths","Data.Job Destruction.Rate","Data.Job Destruction.Rate/Deaths"
"Alabama","1977","933909","52371","46776","5.0","31.0","10634","17.2","8057","13.1","62852","5623","5641","36602","89869","101653","191522","20.5","9.6","85855","144746","58891","15.5","6.3"
"Alaska","1977","108134","6480","-1940","-1.8","69.4","2028","27.0","1564","20.8","7725","1035","1039","6757","19259","18286","37545","34.7","17.8","25981","39485","13504","36.5","12.5"
"Arizona","1977","589552","36477","29997","5.1","39.8","9379","22.0","6230","14.6","44113","4332","4357","29116","70645","76781","147426","25.0","12.0","72063","117429","45366","19.9","7.7"
"Arkansas","1977","529709","35499","42803","8.1","29.0","7291","18.3","5455","13.7","40702","3970","3994","19678","44527","75201","119728","22.6","8.4","44394","76925","32531","14.5","6.1"
"California","1977","6484959","362887","656693","10.1","33.4","88187","20.7","60589","14.2","438766","39693","39932","276475","779164","960214","1739378","26.8","12.0","594123","1082685","488562","16.7","7.5"
"Colorado","1977","786550","51642","55185","7.0","36.4","12874","22.2","8248","14.2","60187","5673","5694","37131","93270","104973","198243","25.2","11.9","80745","143058","62313","18.2","7.9"
"Connecticut","1977","1059999","53879","87622","8.3","24.0","9153","15.2","6634","11.0","61410","4248","4263","24208","69857","144993","214850","20.3","6.6","79955","127228","47273","12.0","4.5"
"Delaware","1977","220859","9919","4553","2.1","27.4","1954","17.6","1250","11.2","11465","807","810","5417","14260","20557","34817","15.8","6.5","21206","30264","9058","13.7","4.1"
"District of Columbia","1977","296031","13027","1695","0.6","39.0","2262","15.2","1855","12.5","15041","1131","1135","9899","27830","31594","59424","20.1","9.4","37119","57729","20610","19.5","7.0"
"Florida","1977","2316656","151970","204491","8.8","36.2","36816","20.7","27045","15.2","182091","19132","19236","120706","319998","302876","622874","26.9","13.8","226401","418383","191982","18.1","8.3"
"Geogia","1977","1452463","78451","80836","5.5","33.0","17573","18.7","13166","14.0","95914","8877","8911","56643","146754","173172","319926","22.0","10.1","141751","239090","97339","16.5","6.7"
"Hawaii","1977","253382","14785","15451","6.1","31.6","3306","19.0","2150","12.4","17914","1422","1438","10556","27592","27993","55585","21.9","10.9","20323","40134","19811","15.8","7.8"
"Idaho","1977","231419","16105","55407","23.9","31.8","3729","20.5","2500","13.7","18790","1738","1749","9788","24359","67757","92116","39.8","10.5","21331","36709","15378","15.9","6.6"
"Illinois","1977","3811704","175560","214845","5.7","27.8","30780","15.2","25527","12.6","204938","16751","16871","107141","293000","452823","745823","19.6","7.7","328929","530978","202049","13.9","5.3"
"Indiana","1977","1669441","79024","78120","4.7","26.4","14426","15.4","11454","12.2","95182","7438","7499","50182","122035","176792","298827","17.9","7.3","139505","220707","81202","13.2","4.9"
"Iowa","1977","809119","54755","57236","7.1","27.6","10154","16.1","7961","12.6","64042","5274","5295","31820","68130","100982","169112","20.9","8.4","61101","111876","50775","13.8","6.3"
"Kansas","1977","655567","44466","56550","8.6","31.6","8534","16.7","6944","13.6","51782","4706","4729","26825","86853","73081","159934","24.4","13.2","58613","103384","44771","15.8","6.8"
"Kentucky","1977","885353","50186","62783","7.1","29.6","9711","16.8","7697","13.3","58576","5214","5226","31052","73635","119856","193491","21.9","8.3","78707","130708","52001","14.8","5.9"
"Louisiana","1977","992319","58952","59409","6.0","33.0","11802","17.3","8216","12.0","70029","5819","5852","37703","96403","126917","223320","22.5","9.7","102161","163911","61750","16.5","6.2"
"Maine","1977","283875","18929","17345","6.1","30.0","3441","16.2","2749","12.9","21673","1756","1762","9457","27020","32860","59880","21.1","9.5","25579","42535","16956","15.0","6.0"
"Maryland","1977","1112672","57557","27494","2.5","35.0","11007","16.4","8105","12.0","68669","5202","5223","33840","87380","135360","222740","20.0","7.9","129470","195246","65776","17.5","5.9"
"Massachusetts","1977","1881581","93706","137713","7.3","26.8","14690","13.7","12039","11.2","108715","7820","7849","55353","156633","232821","389454","20.7","8.3","147392","251741","104349","13.4","5.5"
"Michigan","1977","2620761","122826","194898","7.4","25.8","23171","16.0","18173","12.6","147031","11444","11516","71034","198770","333924","532694","20.3","7.6","208472","337796","129324","12.9","4.9"
"Minnesota","1977","1230894","65489","103634","8.4","29.0","12235","16.2","8977","11.9","76960","5779","5833","43594","108577","173802","282379","22.9","8.8","105537","178745","73208","14.5","5.9"
"Mississippi","1977","560084","34771","41779","7.4","29.0","6881","17.2","5252","13.1","40703","3728","3754","22449","48125","74685","122810","21.9","8.6","46325","81031","34706","14.5","6.2"
"Missouri","1977","1469236","79865","79743","5.4","29.6","15093","16.1","12456","13.3","94772","8281","8321","47534","113532","183319","296851","20.2","7.7","127491","217108","89617","14.8","6.1"
"Montana","1977","178501","16633","24941","13.9","32.4","3670","20.0","2397","13.1","18922","1670","1675","9899","23009","30799","53808","30.1","12.9","15544","28867","13323","16.2","7.5"
"Nebraska","1977","451602","31391","43734","9.7","32.0","5742","16.2","4374","12.3","36091","2971","2982","19346","38510","77529","116039","25.7","8.5","43038","72305","29267","16.0","6.5"
"Nevada","1977","224173","12872","22238","9.9","31.2","3258","23.1","2044","14.5","14682","1465","1469","9485","24771","32400","57171","25.5","11.0","19576","34933","15357","15.6","6.9"
"New Hampshire","1977","253772","16553","16700","6.6","27.2","3204","17.9","2063","11.5","18449","1400","1407","8623","20146","31051","51197","20.2","7.9","19898","34497","14599","13.6","5.8"
"New Jersey","1977","2258998","124638","81477","3.7","30.6","20677","14.8","17341","12.4","141637","11014","11057","63980","178309","249792","428101","19.0","7.9","215066","346624","131558","15.3","5.8"
"New Mexico","1977","266415","20904","15606","5.9","38.6","4889","20.8","3459","14.7","24176","2421","2429","13603","33274","33829","67103","25.2","12.5","29360","51497","22137","19.3","8.3"
"New York","1977","5434966","312227","203029","3.7","31.0","48067","13.7","44902","12.8","353279","31294","31402","181801","402075","642565","1044640","19.2","7.4","517757","841611","323854","15.5","6.0"
"North Carolina","1977","1719698","84511","62591","3.6","28.4","16734","16.7","12387","12.3","102521","8384","8412","51648","132489","174100","306589","17.8","7.7","155901","243998","88097","14.2","5.1"
"North Dakota","1977","146646","13177","5133","3.5","33.4","2435","16.6","1871","12.8","14917","1170","1175","7566","14237","15316","29553","20.2","9.7","13588","24420","10832","16.7","7.4"
"Ohio","1977","3436627","152029","210518","6.2","26.2","27571","14.8","21859","11.7","189077","13726","13812","90134","255150","406990","662140","19.3","7.4","280524","451622","171098","13.1","5.0"
"Oklahoma","1977","721654","50336","49691","6.9","32.0","10526","18.4","7817","13.7","58471","5626","5652","32495","78333","86690","165023","22.9","10.9","64986","115332","50346","16.0","7.0"
"Oregon","1977","672087","46565","47368","7.1","32.2","10970","20.9","7492","14.3","54000","4972","4997","30325","71803","83830","155633","23.2","10.7","57800","108265","50465","16.1","7.5"
"Pennsylvania","1977","3747564","174493","205483","5.4","27.0","28483","13.8","22690","11.0","208707","14433","14526","94367","274187","435878","710065","18.9","7.3","320780","504582","183802","13.5","4.9"
"Rhode Island","1977","324421","17573","67220","20.7","24.2","2770","14.4","2227","11.6","19459","1452","1462","7106","18286","88028","106314","32.8","5.6","24246","39094","14848","12.1","4.6"
"South Carolina","1977","827937","42348","23018","2.7","27.6","8438","17.2","6094","12.4","50173","4204","4229","23887","59698","77247","136945","16.5","7.2","71989","113927","41938","13.8","5.1"
"South Dakota","1977","171956","13882","46709","27.1","29.2","2501","16.2","2013","13.1","15605","1255","1255","6637","25862","45923","71785","41.7","15.0","14577","25076","10499","14.6","6.1"
"Tennessee","1977","1273560","65615","79124","6.2","29.6","13760","17.9","10117","13.2","78338","6941","6971","44016","121560","146050","267610","21.0","9.5","114150","188486","74336","14.8","5.8"
"Texas","1977","3845503","214505","288699","7.5","34.0","49803","19.4","34101","13.3","263754","23575","23750","157804","434064","506539","940603","24.5","11.3","387859","651904","264045","17.0","6.9"
"Utah","1977","339655","21269","33361","9.8","35.0","5073","21.4","3305","14.0","24554","2147","2167","15813","38733","53961","92694","27.3","11.4","33276","59333","26057","17.5","7.7"
"Vermont","1977","139006","10485","12123","8.7","27.6","1914","16.9","1347","11.9","11609","909","912","4669","13726","17583","31309","22.5","9.9","10387","19186","8799","13.8","6.3"
"Virginia","1977","1360683","72552","61605","4.5","32.6","14413","16.7","10720","12.4","88154","6985","7027","42951","127378","155515","282893","20.8","9.4","141854","221288","79434","16.3","5.8"
"Washington","1977","982351","66226","90891","9.2","31.0","15570","20.7","10117","13.4","77856","6565","6595","39509","112311","130401","242712","24.7","11.4","86413","151821","65408","15.5","6.7"
"West Virginia","1977","459237","26551","25289","5.5","32.0","4779","15.7","3800","12.5","30888","2463","2478","13568","41437","57153","98590","21.5","9.0","41655","73301","31646","16.0","6.9"
"Wisconsin","1977","1401243","75854","68083","4.8","24.4","13131","15.3","9807","11.4","87660","6219","6269","38462","96695","142053","238748","17.0","6.9","100721","170665","69944","12.2","5.0"
"Wyoming","1977","102991","9659","12612","12.3","36.6","2260","21.9","1373","13.3","10761","926","928","6309","15382","16116","31498","30.6","14.9","10020","18886","8866","18.3","8.6"
"Alabama","1978","994708","54168","74982","7.5","27.8","10260","16.0","8002","12.5","65096","5667","5688","30942","72111","140955","213066","21.4","7.2","82860","138084","55224","13.9","5.6"
"Alaska","1978","108602","6761","3207","3.0","60.4","1799","22.9","1484","18.9","8010","837","842","6987","13069","22935","36004","33.2","12.0","17715","32797","15082","30.2","13.9"
"Arizona","1978","630226","35147","55641","8.9","34.0","7743","17.8","8348","19.2","43021","4885","4931","28307","60241","102764","163005","25.9","9.6","50500","107364","56864","17.0","9.0"
"Arkansas","1978","556487","33699","14420","2.6","33.4","5932","14.9","7208","18.1","38928","4419","4434","21675","36140","71490","107630","19.3","6.5","45551","93210","47659","16.7","8.6"
"California","1978","7022464","375003","439179","6.3","35.4","81007","18.2","66905","15.0","452620","41450","41725","247948","596335","1085642","1681977","24.0","8.5","714287","1242798","528511","17.7","7.5"
"Colorado","1978","843859","50226","66286","7.8","34.8","10793","18.1","11113","18.6","59213","6706","6740","38425","73365","139709","213074","25.2","8.7","71853","146788","74935","17.4","8.9"
"Connecticut","1978","1121703","55495","36116","3.2","28.0","8081","13.0","6271","10.1","63208","4291","4308","32288","52710","140181","192891","17.2","4.7","93069","156775","63706","14.0","5.7"
"Delaware","1978","223021","9701","-135","-0.1","52.8","1455","12.8","1633","14.4","11289","1231","1232","34224","9385","49585","58970","26.4","4.2","18267","59105","40838","26.5","18.3"
"District of Columbia","1978","307089","13227","20477","6.7","27.4","1950","12.9","1755","11.6","15244","1122","1138","8149","16796","45743","62539","20.4","5.5","25337","42062","16725","13.7","5.4"
"Florida","1978","2491389","159721","146063","5.9","38.0","35042","18.8","26327","14.1","190761","18883","18967","110612","241170","379140","620310","24.9","9.7","283435","474247","190812","19.0","7.7"
"Geogia","1978","1554502","81041","122795","7.9","28.0","15577","16.0","12529","12.9","98922","8709","8746","52218","116387","224365","340752","21.9","7.5","124912","217957","93045","14.0","6.0"
"Hawaii","1978","268253","15388","14309","5.3","31.2","2833","15.5","2190","12.0","18557","1405","1419","7582","21978","34204","56182","20.9","8.2","21735","41873","20138","15.6","7.5"
"Idaho","1978","243944","15632","-28105","-11.5","45.2","3062","16.5","3288","17.7","18330","1912","1921","9996","21739","33434","55173","22.6","8.9","62509","83278","20769","34.1","8.5"
"Illinois","1978","3997676","178543","159067","4.0","27.6","27486","13.3","23997","11.6","208502","16387","16528","98513","219052","492788","711840","17.8","5.5","351351","552773","201422","13.8","5.0"
"Indiana","1978","1768937","81021","121711","6.9","23.4","13090","13.6","10729","11.1","97478","7320","7361","40910","90438","237901","328339","18.6","5.1","129139","206628","77489","11.7","4.4"
"Iowa","1978","856849","56025","38807","4.6","28.0","8988","13.9","7426","11.5","65568","5339","5364","25468","54955","103997","158952","18.6","6.4","78469","120145","41676","14.0","4.9"
"Kansas","1978","691984","45724","18415","2.7","35.2","7850","14.9","6264","11.9","53325","4417","4430","23865","51261","88886","140147","20.3","7.4","80166","121732","41566","17.6","6.0"
"Kentucky","1978","936461","51398","40089","4.3","30.6","9082","15.3","7408","12.5","60188","5233","5245","25056","60162","123672","183834","19.6","6.4","83620","143745","60125","15.3","6.4"
"Louisiana","1978","1062924","56705","91147","8.6","30.6","9461","13.7","10691","15.5","68048","6345","6371","36249","74763","178847","253610","23.9","7.0","89276","162463","73187","15.3","6.9"
"Maine","1978","297080","19655","24411","8.2","25.4","3418","15.5","2533","11.5","22500","1807","1812","8329","19027","43078","62105","20.9","6.4","23223","37694","14471","12.7","4.9"
"Maryland","1978","1150318","59019","49380","4.3","29.8","9599","13.8","7874","11.3","70407","5222","5244","29272","69148","152175","221323","19.2","6.0","108961","171943","62982","14.9","5.5"
"Massachusetts","1978","2022855","95418","145604","7.2","25.0","13209","12.1","11451","10.4","110492","7618","7672","48507","114895","283687","398582","19.7","5.7","142101","252978","110877","12.5","5.5"
"Michigan","1978","2793463","125933","186167","6.7","23.8","21107","14.2","17433","11.7","150639","11581","11637","69164","166774","353036","519810","18.6","6.0","195037","333643","138606","11.9","5.0"
"Minnesota","1978","1327630","67767","90105","6.8","29.4","11114","14.2","8496","10.9","79558","5870","5900","34237","83671","201749","285420","21.5","6.3","127607","195315","67708","14.7","5.1"
"Mississippi","1978","594424","35073","26760","4.5","31.4","6185","15.1","5694","13.9","41205","3800","3811","17983","42856","77178","120034","20.2","7.2","59294","93274","33980","15.7","5.7"
"Missouri","1978","1550852","81346","83899","5.4","29.2","14054","14.7","12019","12.6","96711","8268","8297","40896","99056","211143","310199","20.0","6.4","132939","226300","93361","14.6","6.0"
"Montana","1978","193375","15956","6928","3.6","41.2","2890","15.5","3267","17.5","18322","1916","1920","9760","16139","30577","46716","24.2","8.3","20164","39788","19624","20.6","10.1"
"Nebraska","1978","477295","32033","8141","1.7","37.8","5004","13.7","4157","11.4","36894","2951","2975","15148","30239","68111","98350","20.6","6.3","56976","90209","33233","18.9","7.0"
"Nevada","1978","251213","12572","34309","13.7","30.6","2841","19.5","2875","19.7","14468","1633","1637","11388","25063","47739","72802","29.0","10.0","15207","38493","23286","15.3","9.3"
"New Hampshire","1978","278607","17428","33434","12.0","23.0","3132","16.5","2141","11.3","19426","1528","1534","7214","25241","40197","65438","23.5","9.1","18843","32004","13161","11.5","4.7"
"New Jersey","1978","2348078","127081","106806","4.6","28.8","19059","13.3","16284","11.4","144463","10775","10816","58403","137481","307642","445123","19.0","5.9","198386","338317","139931","14.4","6.0"
"New Mexico","1978","282983","19821","20954","7.4","37.2","3820","16.1","4419","18.6","23243","2715","2719","17516","25533","48035","73568","26.0","9.0","22834","52614","29780","18.6","10.5"
"New York","1978","5662022","313062","210945","3.7","31.6","43751","12.4","43379","12.3","353760","30832","30932","172072","315152","787689","1102841","19.5","5.6","538174","891896","353722","15.8","6.2"
"North Carolina","1978","1799943","87640","108631","6.1","24.0","15728","15.1","12132","11.6","106079","8526","8562","43857","108021","217277","325298","18.1","6.0","125137","216667","91530","12.0","5.1"
"North Dakota","1978","156069","13603","13863","8.9","25.0","2203","14.5","1709","11.3","15383","1189","1193","5327","11304","22060","33364","21.4","7.2","11377","19501","8124","12.5","5.2"
"Ohio","1978","3603082","154897","130143","3.6","27.0","24430","12.8","20672","10.8","192855","13610","13667","71255","178168","437396","615564","17.1","4.9","321837","485421","163584","13.5","4.5"
"Oklahoma","1978","759417","47600","32059","4.2","34.6","8755","15.3","10543","18.4","55988","6344","6360","36622","59579","103541","163120","21.5","7.8","59711","131061","71350","17.3","9.4"
"Oregon","1978","747631","49114","104627","14.0","27.0","10748","19.4","7828","14.1","56878","5283","5301","27853","69772","135725","205497","27.5","9.3","48821","100870","52049","13.5","7.0"
"Pennsylvania","1978","3879649","176944","78539","2.0","31.8","25306","12.0","22355","10.6","211614","14774","14859","119050","198829","495614","694443","17.9","5.1","380318","615904","235586","15.9","6.1"
"Rhode Island","1978","345722","17892","-24272","-7.0","39.2","2499","12.7","2088","10.6","19843","1438","1440","7988","20710","46932","67642","19.6","6.0","73430","91914","18484","26.6","5.3"
"South Carolina","1978","875944","43868","74950","8.5","22.4","8030","15.7","6095","11.9","52112","4392","4403","18593","64901","108073","172974","19.7","7.4","58398","98024","39626","11.2","4.5"
"South Dakota","1978","182954","14365","-23805","-13.0","40.8","2415","15.2","1864","11.7","16130","1305","1306","5665","12789","24533","37322","20.4","7.0","52051","61127","9076","33.4","5.0"
"Tennessee","1978","1350566","67459","72080","5.3","29.6","12067","15.2","9967","12.6","80407","6950","6972","38450","87492","184052","271544","20.1","6.5","120794","199464","78670","14.8","5.8"
"Texas","1978","4089419","204020","240566","5.9","35.0","40567","15.7","46430","17.9","254416","26558","26702","174431","326654","630540","957194","23.4","8.0","359133","716628","357495","17.5","8.7"
"Utah","1978","365349","20623","22425","6.1","34.6","4125","17.0","4355","17.9","24015","2401","2410","14870","31944","53514","85458","23.4","8.7","32015","63033","31018","17.3","8.5"
"Vermont","1978","151138","11078","12825","8.5","30.6","1913","16.1","1288","10.8","12226","961","968","4973","13881","22044","35925","23.8","9.2","10856","23100","12244","15.3","8.1"
"Virginia","1978","1433692","75541","86133","6.0","27.8","13626","15.2","10060","11.2","91681","6880","6907","42339","93808","192125","285933","19.9","6.5","117538","199800","82262","13.9","5.7"
"Washington","1978","1113157","69558","172457","15.5","28.2","15023","18.8","11137","14.0","81677","7033","7057","40738","104323","225041","329364","29.6","9.4","83313","156907","73594","14.1","6.6"
"West Virginia","1978","462161","26917","-17527","-3.8","31.4","4177","13.4","3756","12.1","31297","2478","2484","11280","23609","48979","72588","15.7","5.1","66095","90115","24020","19.5","5.2"
"Wisconsin","1978","1489387","78852","112330","7.5","21.4","12536","14.0","9124","10.2","91036","6361","6389","34761","83921","187243","271164","18.2","5.6","91230","158834","67604","10.7","4.5"
"Wyoming","1978","116514","9470","15684","13.4","37.0","1984","18.5","1971","18.4","10634","1178","1180","6059","13906","23294","37200","31.9","11.9","9251","21516","12265","18.5","10.5"
"Alabama","1979","1055982","54730","54261","5.2","31.2","9436","14.4","8106","12.4","65955","5899","5914","35731","75192","144164","219356","20.8","7.1","100363","165095","64732","15.6","6.1"
"Alaska","1979","108822","7058","-1884","-1.7","53.2","1804","22.1","1400","17.2","8298","904","907","5560","11685","17229","28914","26.6","10.7","18707","30798","12091","28.3","11.1"
"Arizona","1979","714182","40325","108030","15.2","26.2","9229","20.1","3881","8.5","48734","118","132","1452","75771","126007","201778","28.3","10.6","62605","93748","31143","13.1","4.4"
"Arkansas","1979","583549","36633","37990","6.5","26.0","6430","15.9","3658","9.0","41977","66","73","2171","43304","70351","113655","19.5","7.4","53062","75665","22603","13.0","3.9"
"California","1979","7568239","397902","681095","9.0","31.0","89981","19.3","60626","13.0","478672","41901","42089","257452","720477","1136004","1856481","24.5","9.5","699842","1175386","475544","15.5","6.3"
"Colorado","1979","932493","56438","106725","11.5","27.4","12087","19.4","6051","9.7","65644","106","123","3424","89746","145092","234838","25.2","9.6","80305","128113","47808","13.7","5.1"
"Connecticut","1979","1174374","56971","71566","6.1","21.8","7968","12.4","6031","9.4","64839","4160","4167","21983","62534","136979","199513","17.0","5.3","82334","127947","45613","10.9","3.9"
"Delaware","1979","213347","9922","-18159","-8.5","29.4","1545","13.5","1203","10.5","11562","809","820","3978","11430","19900","31330","14.7","5.4","41317","49489","8172","23.2","3.8"
"District of Columbia","1979","330425","13368","26968","8.1","22.8","1872","12.2","1607","10.5","15419","1053","1054","6545","14835","49643","64478","19.5","4.5","22458","37510","15052","11.4","4.6"
"Florida","1979","2671506","167423","225400","8.4","32.4","35973","18.4","25357","13.0","200091","18717","18822","114510","265284","392538","657822","24.6","9.9","249575","432422","182847","16.2","6.8"
"Geogia","1979","1656238","82563","81958","4.9","29.8","15322","15.3","12250","12.2","101415","8777","8797","46769","125154","202777","327931","19.8","7.6","156278","245973","89695","14.9","5.4"
"Hawaii","1979","287811","16172","23484","8.2","28.2","3148","16.5","2052","10.8","19545","1398","1407","8575","24331","39866","64197","22.3","8.5","25097","40713","15616","14.1","5.4"
"Idaho","1979","252502","17198","40994","16.2","30.0","3259","17.0","1729","9.0","20007","33","34","369","48351","30394","78745","31.2","19.1","25955","37751","11796","15.0","4.7"
"Illinois","1979","4163606","179478","185063","4.4","27.2","26460","12.6","23364","11.2","210329","16189","16242","99206","235057","515122","750179","18.0","5.6","352399","565116","212717","13.6","5.1"
"Indiana","1979","1858703","81904","63155","3.4","26.2","12611","12.8","10611","10.8","98946","7566","7599","41438","94981","211700","306681","16.5","5.1","163990","243526","79536","13.1","4.3"
"Iowa","1979","896269","55826","42832","4.8","25.8","7941","12.1","7600","11.6","65548","5485","5546","26839","52737","106113","158850","17.7","5.9","70415","116018","45603","12.9","5.1"
"Kansas","1979","722802","46263","46063","6.4","27.4","7218","13.4","6219","11.6","54040","4448","4460","22021","46496","98673","145169","20.1","6.4","59225","99106","39881","13.7","5.5"
"Kentucky","1979","982930","52229","55687","5.7","28.6","8596","14.1","7006","11.5","61390","5151","5164","29037","67028","129226","196254","20.0","6.8","88712","140567","51855","14.3","5.3"
"Louisiana","1979","1165412","62363","100925","8.7","27.4","11200","15.7","5514","7.8","74231","57","76","1700","89541","171281","260822","22.4","7.7","109185","159897","50712","13.7","4.4"
"Maine","1979","312846","19874","8034","2.5","29.2","3054","13.5","2590","11.4","22803","1844","1850","8580","19386","34199","53585","17.1","6.2","30445","45551","15106","14.6","4.8"
"Maryland","1979","1201420","60029","55840","4.6","27.8","9756","13.7","7883","11.1","71902","5445","5480","29949","73270","149293","222563","18.5","6.1","101360","166723","65363","13.9","5.4"
"Massachusetts","1979","2149249","96906","111397","5.2","25.6","13252","11.9","10914","9.8","112318","7506","7533","45723","115994","270818","386812","18.0","5.4","186973","275415","88442","12.8","4.1"
"Michigan","1979","2985065","127979","157154","5.3","23.6","20204","13.3","16678","11.0","153321","11511","11570","69149","160823","348988","509811","17.1","5.4","226188","352657","126469","11.8","4.2"
"Minnesota","1979","1422387","69373","100036","7.1","25.8","10829","13.4","8499","10.6","81497","5920","5940","33403","92124","191843","283967","20.0","6.5","117867","183931","66064","12.9","4.6"
"Mississippi","1979","626893","36186","38959","6.2","29.2","6614","15.8","4992","11.9","42542","3734","3745","19545","45033","85413","130446","20.8","7.2","56995","91487","34492","14.6","5.5"
"Missouri","1979","1635903","82490","92595","5.7","26.0","13335","13.7","11340","11.6","98170","7979","8040","43086","94849","211182","306031","18.7","5.8","131858","213436","81578","13.0","5.0"
"Montana","1979","212784","17673","30562","14.4","26.0","3324","17.3","1689","8.8","20098","20","20","221","19182","39029","58211","27.4","9.0","18893","27649","8756","13.0","4.1"
"Nebraska","1979","490865","32331","20674","4.2","29.4","4608","12.4","4047","10.9","37234","2796","2802","12552","28082","64894","92976","18.9","5.7","49513","72302","22789","14.7","4.6"
"Nevada","1979","295553","14667","52420","17.7","25.6","3551","22.7","1366","8.7","16788","90","91","842","37943","52259","90202","30.5","12.8","24723","37782","13059","12.8","4.4"
"New Hampshire","1979","307687","17921","25627","8.3","24.6","2936","14.9","2196","11.1","20047","1577","1583","7407","19477","43978","63455","20.6","6.3","23817","37828","14011","12.3","4.6"
"New Jersey","1979","2452369","130213","107346","4.4","27.8","19551","13.4","15093","10.3","148059","10295","10322","56858","150545","298839","449384","18.3","6.1","220483","342038","121555","13.9","5.0"
"New Mexico","1979","311227","22016","33049","10.6","29.2","4471","18.3","2309","9.5","25590","36","41","832","31773","46619","78392","25.2","10.2","28600","45343","16743","14.6","5.4"
"New York","1979","5829407","314425","138873","2.4","30.2","43039","12.1","39583","11.2","355506","28950","29064","162524","316196","701771","1017967","17.5","5.4","570261","879094","308833","15.1","5.3"
"North Carolina","1979","1910551","89357","116900","6.1","23.2","15066","14.0","11909","11.1","108599","8614","8634","44753","114582","224295","338877","17.7","6.0","135984","221977","85993","11.6","4.5"
"North Dakota","1979","170166","13973","15194","8.9","28.2","2263","14.5","1731","11.1","15791","1246","1247","6591","14478","24693","39171","23.0","8.5","14554","23977","9423","14.1","5.5"
"Ohio","1979","3750740","156872","173651","4.7","24.0","23967","12.3","20219","10.4","195658","13348","13400","74907","198112","426534","624646","16.7","5.3","282961","450995","168034","12.0","4.5"
"Oklahoma","1979","821971","52568","88952","10.8","26.2","9984","17.0","4991","8.5","61399","91","98","1235","71145","125153","196298","23.9","8.7","70379","107346","36967","13.1","4.5"
"Oregon","1979","834609","51134","74869","8.9","33.2","10747","18.5","7874","13.6","59275","5680","5688","30102","72124","140890","213014","25.5","8.6","85222","138145","52923","16.6","6.3"
"Pennsylvania","1979","3960793","178595","92812","2.3","27.6","24802","11.6","21000","9.9","214372","14390","14461","78761","188922","449484","638406","16.1","4.8","370324","545594","175270","13.8","4.4"
"Rhode Island","1979","337806","18273","9143","2.7","29.0","2451","12.2","1917","9.6","20277","1340","1342","7370","18715","39480","58195","17.2","5.5","34711","49052","14341","14.5","4.2"
"South Carolina","1979","938815","44350","49177","5.2","24.4","7374","14.0","6155","11.7","53006","4523","4557","22195","51789","111783","163572","17.4","5.5","76113","114395","38282","12.2","4.1"
"South Dakota","1979","178064","14557","14890","8.4","27.6","2257","13.9","1868","11.5","16417","1327","1328","6139","14858","24609","39467","22.2","8.3","14673","24577","9904","13.8","5.6"
"Tennessee","1979","1421203","68306","73338","5.1","28.4","11986","14.8","10104","12.5","81771","7187","7199","38245","96506","178058","274564","19.3","6.8","128412","201226","72814","14.2","5.1"
"Texas","1979","4451203","228595","451452","10.1","28.8","47590","17.7","22228","8.3","282055","308","381","9442","419040","671394","1090434","24.5","9.4","439461","638982","199521","14.4","4.5"
"Utah","1979","395122","23101","35314","8.9","28.6","4560","18.0","2025","8.0","26722","37","41","650","36997","54790","91787","23.2","9.4","38782","56473","17691","14.3","4.5"
"Vermont","1979","160819","11344","6980","4.3","29.0","1753","14.1","1360","11.0","12557","1040","1046","5397","10357","19877","30234","18.8","6.4","15077","23254","8177","14.5","5.1"
"Virginia","1979","1512843","77100","76426","5.0","28.0","13106","14.1","10377","11.2","93949","7399","7422","37383","99825","187755","287580","19.0","6.6","137497","211154","73657","14.0","4.9"
"Washington","1979","1207327","72969","21734","1.8","44.0","15324","18.3","10892","13.0","85408","7480","7512","40436","105212","182586","287798","23.8","8.7","167217","266064","98847","22.0","8.2"
"West Virginia","1979","489740","27284","74917","15.3","23.4","4349","13.8","3581","11.3","31823","2529","2536","10888","28775","103521","132296","27.0","5.9","36534","57379","20845","11.7","4.3"
"Wisconsin","1979","1583678","80177","76841","4.8","23.2","11376","12.4","9199","10.0","92794","6444","6463","33301","82724","177195","259919","16.4","5.2","119411","183078","63667","11.6","4.0"
"Wyoming","1979","132024","10651","14572","11.1","32.2","2227","19.7","1015","9.0","11919","25","26","272","15479","20374","35853","27.2","11.7","14736","21281","6545","16.1","5.0"
"Alabama","1980","1080875","54494","-614","-0.1","33.2","8630","13.1","8426","12.8","65852","6072","6086","33755","61121","118247","179368","16.6","5.7","121929","179982","58053","16.7","5.4"
"Alaska","1980","107880","7082","879","0.8","43.4","1477","17.8","1346","16.2","8324","886","892","4606","8883","15370","24253","22.5","8.2","15486","23374","7888","21.7","7.3"
"Arizona","1980","784645","42362","36071","4.6","34.8","9389","18.8","6662","13.3","51152","4763","4775","28763","72404","100541","172945","22.0","9.2","88143","136874","48731","17.4","6.2"
"Arkansas","1980","610998","36610","18119","3.0","30.8","5628","13.4","5457","13.0","41952","3971","3981","17746","36084","76352","112436","18.4","5.9","62413","94317","31904","15.4","5.2"
"California","1980","8070425","411314","344867","4.3","34.2","81844","16.8","63887","13.1","494149","44372","44573","281515","662641","1061473","1724114","21.4","8.2","869257","1379247","509990","17.1","6.3"
"Colorado","1980","1001872","58297","38820","3.9","34.4","11825","17.7","9311","14.0","67728","6583","6606","42218","85392","126037","211429","21.1","8.5","99731","172609","72878","17.2","7.3"
"Connecticut","1980","1230114","57616","44697","3.6","24.2","7590","11.6","6535","10.0","65666","4554","4595","23569","60611","132484","193095","15.7","4.9","100527","148398","47871","12.1","3.9"
"Delaware","1980","207446","9956","6830","3.3","23.8","1342","11.6","1316","11.4","11551","887","912","4646","11142","20340","31482","15.2","5.4","15446","24652","9206","11.9","4.4"
"District of Columbia","1980","349621","13573","12545","3.6","36.6","1882","12.1","1682","10.8","15600","1095","1099","7388","16839","59652","76491","21.9","4.8","33780","63946","30166","18.3","8.6"
"Florida","1980","2876941","175454","182066","6.4","32.8","36311","17.7","26348","12.9","209305","19499","19564","116237","281115","373603","654718","22.8","9.8","284735","472652","187917","16.4","6.5"
"Geogia","1980","1717525","83538","41210","2.4","30.6","14144","13.9","12510","12.3","102668","8830","8872","47751","112458","192161","304619","17.7","6.5","169316","263409","94093","15.3","5.5"
"Hawaii","1980","301581","16929","5417","1.8","32.6","3142","15.7","2176","10.9","20433","1460","1474","9700","23490","31079","54569","18.1","7.8","32141","49152","17011","16.3","5.6"
"Idaho","1980","260249","17306","-24760","-9.5","37.4","3033","15.1","2750","13.7","20154","1959","1967","9969","18415","30177","48592","18.7","7.1","55959","73352","17393","28.2","6.7"
"Illinois","1980","4218402","179908","-68701","-1.6","27.8","24930","11.8","23577","11.2","211082","16441","16526","94857","214790","370801","585591","13.9","5.1","455441","654292","198851","15.5","4.7"
"Indiana","1980","1861237","81874","-52873","-2.9","27.0","11525","11.6","10941","11.0","99140","7641","7676","39265","93016","158466","251482","13.5","5.0","222909","304355","81446","16.4","4.4"
"Iowa","1980","913100","55749","-4878","-0.5","29.6","7611","11.6","7178","10.9","65666","5314","5327","28356","49251","85855","135106","14.8","5.4","91916","139984","48068","15.3","5.3"
"Kansas","1980","749703","46254","9825","1.3","30.4","6597","12.2","6339","11.7","54081","4532","4543","22525","44071","79400","123471","16.5","5.9","78121","113646","35525","15.2","4.7"
"Kentucky","1980","1007266","51793","-4731","-0.5","31.0","7362","12.0","7329","12.0","61174","5356","5372","27403","54795","101447","156242","15.5","5.4","113943","160973","47030","16.0","4.7"
"Louisiana","1980","1231262","63552","34288","2.8","34.0","10607","14.1","8772","11.7","75731","6320","6352","39622","84660","159466","244126","19.8","6.9","142238","209838","67600","17.0","5.5"
"Maine","1980","317362","19757","2500","0.8","30.0","2758","12.1","2668","11.7","22728","1847","1858","8536","16786","33210","49996","15.8","5.3","30755","47496","16741","15.0","5.3"
"Maryland","1980","1264884","60838","65631","5.2","29.4","9143","12.6","8028","11.1","72838","5417","5452","31888","102859","149099","251958","19.9","8.1","125727","186327","60600","14.7","4.8"
"Massachusetts","1980","2239912","97762","71154","3.2","27.0","12445","11.0","11065","9.8","113338","7517","7569","48711","108281","265300","373581","16.7","4.8","201806","302427","100621","13.5","4.5"
"Michigan","1980","2970906","127753","-172306","-5.8","25.2","18598","12.1","17456","11.4","153767","12019","12059","67307","145181","230487","375668","12.6","4.9","406278","547974","141696","18.4","4.8"
"Minnesota","1980","1484861","70287","26799","1.8","29.2","9964","12.1","8543","10.4","82646","5943","5982","39022","83514","160369","243883","16.4","5.6","144696","217084","72388","14.6","4.9"
"Mississippi","1980","645528","36518","-1355","-0.2","32.4","5817","13.6","5158","12.1","43031","3773","3796","19808","39621","65167","104788","16.2","6.1","71603","106143","34540","16.4","5.4"
"Missouri","1980","1676529","82350","-7585","-0.4","30.4","11971","12.2","11547","11.8","98116","8152","8175","41837","89912","164443","254355","15.2","5.4","177757","261940","84183","15.6","5.0"
"Montana","1980","223406","17724","-9082","-4.1","34.2","2891","14.4","2704","13.4","20141","1870","1876","9335","16849","21449","38298","17.1","7.5","32629","47380","14751","21.2","6.6"
"Nebraska","1980","506666","32400","12918","2.5","28.8","4429","11.9","4153","11.1","37353","2975","2984","14816","29239","56596","85835","16.9","5.8","49632","72917","23285","14.4","4.6"
"Nevada","1980","329669","15355","19228","5.8","36.0","3431","19.9","2477","14.4","17631","1794","1801","16658","32628","45896","78524","23.8","9.9","36336","59296","22960","18.0","7.0"
"New Hampshire","1980","323960","18005","7552","2.4","29.4","2553","12.7","2334","11.6","20158","1672","1679","9597","18195","37087","55282","17.1","5.6","30186","47730","17544","14.7","5.4"
"New Jersey","1980","2524700","132229","38501","1.6","29.4","18191","12.2","15533","10.4","150343","10873","10914","57552","136458","274374","410832","16.3","5.4","253443","372331","118888","14.7","4.7"
"New Mexico","1980","328117","22407","2871","0.9","39.4","4234","16.4","3553","13.8","26027","2525","2529","14673","29326","38310","67636","20.6","8.9","40273","64765","24492","19.7","7.5"
"New York","1980","5918068","314762","99467","1.7","29.4","40377","11.4","39226","11.0","355779","28818","28890","158956","314390","653406","967796","16.4","5.3","568567","868329","299762","14.7","5.1"
"North Carolina","1980","1988483","89884","24215","1.3","27.2","13844","12.7","12449","11.4","109519","8888","8926","49223","100393","195073","295466","14.9","5.0","184617","271251","86634","13.6","4.4"
"North Dakota","1980","180081","14077","5865","3.3","30.6","2058","13.0","1796","11.3","15978","1278","1279","6586","13115","20329","33444","18.6","7.3","17715","27579","9864","15.3","5.5"
"Ohio","1980","3806420","156831","-57071","-1.5","27.4","21720","11.1","20491","10.5","196098","13738","13828","75324","180440","340587","521027","13.7","4.7","414903","578098","163195","15.2","4.3"
"Oklahoma","1980","885106","53632","43154","4.9","33.0","9550","15.4","7961","12.8","62673","5882","5909","30204","76640","112546","189186","21.4","8.7","96008","146032","50024","16.5","5.7"
"Oregon","1980","862988","51986","-15987","-1.9","37.8","9942","16.6","8601","14.4","60328","6109","6140","33179","67872","95373","163245","18.9","7.9","122511","179232","56721","20.8","6.6"
"Pennsylvania","1980","4022847","178026","21165","0.5","27.8","22704","10.6","22079","10.3","214132","15214","15277","86745","193932","385279","579211","14.4","4.8","370928","558046","187118","13.9","4.7"
"Rhode Island","1980","340926","18311","-306","-0.1","28.0","2176","10.7","2090","10.3","20297","1458","1459","7406","15267","32633","47900","14.0","4.5","34467","48206","13739","14.1","4.0"
"South Carolina","1980","966684","44827","8346","0.9","28.0","7169","13.4","6323","11.9","53627","4506","4523","21057","52465","91681","144146","14.9","5.4","93018","135800","42782","14.0","4.4"
"South Dakota","1980","186117","14648","1404","0.7","32.0","2057","12.5","1861","11.3","16540","1364","1368","6774","13029","18112","31141","16.7","7.0","19283","29737","10454","16.0","5.6"
"Tennessee","1980","1445831","68649","-20929","-1.4","31.2","11109","13.5","10164","12.4","82403","7236","7251","39818","85830","139098","224928","15.6","5.9","168614","245857","77243","17.0","5.3"
"Texas","1980","4604289","197706","77394","1.7","35.6","28147","10.5","41043","15.3","252919","30408","30581","192868","273070","626014","899084","19.5","5.9","496080","821690","325610","17.8","7.1"
"Utah","1980","416219","23139","9470","2.3","34.6","4206","15.7","3808","14.2","26904","2678","2693","15608","32823","48597","81420","19.6","7.9","44565","71950","27385","17.3","6.6"
"Vermont","1980","166906","11514","5386","3.2","28.2","1652","13.1","1397","11.0","12749","1056","1058","4549","9035","19898","28933","17.3","5.4","16324","23547","7223","14.1","4.3"
"Virginia","1980","1569964","77942","41972","2.7","27.8","12450","13.2","10822","11.4","95157","7573","7604","37651","92235","168273","260508","16.6","5.9","148006","218536","70530","13.9","4.5"
"Washington","1980","1237123","73976","42897","3.5","34.8","13661","15.9","11661","13.5","86798","8098","8126","43343","94134","164374","258508","20.9","7.6","140517","215611","75094","17.4","6.1"
"West Virginia","1980","506848","27159","-39855","-7.9","28.0","3750","11.8","3669","11.5","31783","2621","2630","12632","26362","44796","71158","14.0","5.2","86345","111013","24668","21.9","4.9"
"Wisconsin","1980","1618761","80392","-1467","-0.1","26.2","10351","11.1","9544","10.3","93227","6749","6781","35373","72931","139045","211976","13.1","4.5","147356","213443","66087","13.2","4.1"
"Wyoming","1980","143298","10947","8824","6.1","35.6","2084","17.2","1608","13.3","12300","1172","1175","6648","13664","20635","34299","23.9","9.5","15833","25475","9642","17.8","6.7"
"Alabama","1981","1049506","52551","-20668","-1.9","33.2","7972","12.4","9381","14.6","63502","6056","6081","37042","71309","102501","173810","16.6","6.8","116628","194478","77850","18.5","7.4"
"Alaska","1981","106881","7104","9664","9.1","38.8","1480","17.9","1336","16.2","8283","748","750","4444","11824","18584","30408","28.5","11.1","11896","20744","8848","19.4","8.3"
"Arizona","1981","797439","42385","17027","2.1","37.0","8941","17.5","8199","16.0","51310","5241","5257","30259","68460","95919","164379","20.6","8.6","89514","147352","57838","18.5","7.3"
"Arkansas","1981","583058","35019","-13861","-2.4","32.4","5424","13.3","6144","15.0","40278","4014","4028","19401","44911","49793","94704","16.2","7.7","70924","108565","37641","18.6","6.5"
"California","1981","8205240","408274","45686","0.6","40.2","76971","15.7","77407","15.8","488896","45626","45863","290518","694330","1003049","1697379","20.7","8.5","986368","1651693","665325","20.1","8.1"
"Colorado","1981","1017881","57785","31012","3.1","39.8","11484","17.1","11258","16.7","67245","7006","7037","45832","100146","133512","233658","23.0","9.8","115902","202646","86744","19.9","8.5"
"Connecticut","1981","1240396","56444","5677","0.4","28.0","7366","11.4","8268","12.8","64151","4738","4744","25687","70315","108764","179079","14.4","5.7","105623","173402","67779","14.0","5.5"
"Delaware","1981","211575","9706","2759","1.3","27.2","1280","11.2","1488","13.1","11249","839","842","4517","12208","19396","31604","14.9","5.8","18108","28845","10737","13.6","5.1"
"District of Columbia","1981","354941","13115","-11946","-3.4","38.6","1781","11.6","2198","14.4","15030","1184","1189","12545","25259","43395","68654","19.3","7.1","29923","80600","50677","22.7","14.3"
"Florida","1981","3014820","178244","122726","4.1","37.8","36207","17.2","31440","14.9","212419","20613","20701","120653","286356","406880","693236","23.0","9.5","336391","570510","234119","18.9","7.8"
"Geogia","1981","1720873","81987","18718","1.1","35.4","13777","13.6","14441","14.2","100899","8847","8869","48297","131821","191587","323408","18.8","7.7","181331","304690","123359","17.7","7.2"
"Hawaii","1981","305274","17073","5764","1.9","34.0","3000","14.7","2850","14.0","20406","1700","1733","10583","27216","30590","57806","18.9","8.9","31085","52042","20957","17.0","6.9"
"Idaho","1981","250145","16460","13021","5.2","38.6","2667","13.6","3213","16.4","19227","2057","2077","9980","36287","25111","61398","24.5","14.5","29812","48377","18565","19.3","7.4"
"Illinois","1981","4025498","173447","-124294","-3.1","28.6","23382","11.3","28369","13.7","203368","16410","16529","109079","227322","349516","576838","14.3","5.6","438562","701132","262570","17.4","6.5"
"Indiana","1981","1765454","78583","-49932","-2.8","28.2","10378","10.7","13009","13.4","95289","7688","7722","41752","95769","153063","248832","14.1","5.4","191803","298764","106961","16.9","6.1"
"Iowa","1981","872749","53766","-30401","-3.5","30.6","7035","10.9","8526","13.2","63474","5316","5338","25683","68295","65443","133738","15.3","7.8","99691","164139","64448","18.8","7.4"
"Kansas","1981","739441","45126","-3499","-0.4","33.0","6710","12.6","7473","14.0","52682","4605","4625","24088","55555","66156","121711","16.5","7.5","77685","125210","47525","16.9","6.4"
"Kentucky","1981","944698","49848","-22503","-2.4","30.8","6978","11.7","8213","13.8","58912","5102","5119","26963","58431","87159","145590","15.4","6.2","108747","168093","59346","17.8","6.3"
"Louisiana","1981","1259344","63310","45361","3.6","34.8","10629","14.1","10254","13.6","75338","6453","6491","39080","101116","163285","264401","21.0","8.0","136792","219040","82248","17.4","6.5"
"Maine","1981","311506","19128","220","0.0","32.4","2611","11.7","3003","13.5","21998","1849","1858","8441","17665","32882","50547","16.2","5.7","29500","50327","20827","16.2","6.7"
"Maryland","1981","1275299","59739","-28660","-2.2","33.6","8897","12.3","9797","13.6","71488","5568","5591","32202","86602","127592","214194","16.8","6.8","157693","242854","85161","19.0","6.7"
"Massachusetts","1981","2260249","96214","-2307","-0.1","32.4","12150","10.8","13281","11.8","111344","7436","7478","57603","125367","241852","367219","16.2","5.5","213228","369526","156298","16.3","6.9"
"Michigan","1981","2802878","123243","-125872","-4.5","27.6","17059","11.3","21384","14.2","147901","12000","12080","65260","164571","221266","385837","13.8","5.9","326801","511709","184908","18.3","6.6"
"Minnesota","1981","1463405","68780","-17260","-1.2","32.4","9428","11.6","10300","12.6","80765","5945","5974","41864","98844","137842","236686","16.2","6.8","156760","253946","97186","17.4","6.6"
"Mississippi","1981","601942","35092","-9810","-1.7","31.4","5057","12.0","6053","14.4","41408","3941","3949","19855","36504","58281","94785","15.7","6.1","67661","104595","36934","17.4","6.1"
"Missouri","1981","1622808","79623","-11424","-0.7","32.0","11598","12.1","13557","14.1","94775","8124","8151","41830","102839","156455","259294","16.0","6.3","167229","270718","103489","16.7","6.4"
"Montana","1981","200481","17112","-1948","-1.0","37.8","2734","14.0","2907","14.8","19422","1814","1814","9491","15830","22158","37988","18.9","7.9","22600","39936","17336","19.9","8.6"
"Nebraska","1981","482591","30846","3655","0.8","32.6","4092","11.4","4785","13.3","35583","2813","2818","13933","33029","49386","82415","17.1","6.8","47091","78760","31669","16.3","6.6"
"Nevada","1981","334726","15347","-4290","-1.3","42.0","3230","18.3","2985","16.9","17668","1861","1865","11907","30682","39723","70405","21.0","9.2","46445","74695","28250","22.3","8.4"
"New Hampshire","1981","317448","17549","3834","1.2","34.4","2597","13.1","2699","13.6","19671","1636","1639","8820","21577","36910","58487","18.4","6.8","31499","54653","23154","17.2","7.3"
"New Jersey","1981","2514843","129561","21145","0.8","32.6","17249","11.6","19125","12.9","147107","11362","11404","58814","164498","265622","430120","17.1","6.5","242552","408975","166423","16.3","6.6"
"New Mexico","1981","325449","22018","5006","1.6","40.2","3923","15.2","4092","15.9","25535","2629","2639","15593","29721","40846","70567","21.7","9.1","37925","65561","27636","20.1","8.5"
"New York","1981","5862840","307251","-54009","-0.9","32.6","38945","11.1","45640","13.0","346538","28454","28579","155841","342525","614439","956964","16.3","5.8","607490","1010973","403483","17.2","6.9"
"North Carolina","1981","1966888","87816","-4599","-0.3","30.2","13278","12.3","14688","13.6","107193","9063","9091","49490","116106","181560","297666","15.1","5.9","184865","302265","117400","15.4","6.0"
"North Dakota","1981","170036","13541","-971","-0.6","33.6","1969","12.7","2036","13.1","15447","1252","1253","6111","12930","15666","28596","16.8","7.6","18681","29567","10886","17.4","6.4"
"Ohio","1981","3615444","151532","-153504","-4.2","25.6","20338","10.6","25160","13.1","189344","13901","13973","77288","188313","273872","462185","12.8","5.2","393632","615689","222057","17.0","6.1"
"Oklahoma","1981","894851","53266","43494","4.8","33.6","9586","15.4","9200","14.8","62109","6098","6113","32564","79984","113722","193706","21.6","8.9","85163","150212","65049","16.8","7.3"
"Oregon","1981","812999","50412","-33123","-4.1","33.6","9010","15.2","9905","16.7","58527","6146","6168","34569","66356","70584","136940","16.8","8.2","102140","170063","67923","20.9","8.4"
"Pennsylvania","1981","3985643","170981","-49939","-1.2","29.0","20903","10.0","26660","12.7","206089","15340","15409","89073","230610","345362","575972","14.5","5.8","394983","625911","230928","15.7","5.8"
"Rhode Island","1981","337114","17847","-5389","-1.6","29.4","2144","10.7","2490","12.4","19791","1480","1484","8297","19112","30486","49598","14.7","5.7","33873","54987","21114","16.3","6.3"
"South Carolina","1981","952226","43447","-5566","-0.6","30.0","6773","12.8","7641","14.5","52240","4654","4671","26123","57611","85175","142786","15.0","6.1","89943","148352","58409","15.6","6.1"
"South Dakota","1981","171563","13981","-4828","-2.8","29.2","1762","11.0","2150","13.4","15802","1332","1336","6566","11275","13817","25092","14.6","6.6","18426","29920","11494","17.4","6.7"
"Tennessee","1981","1403176","66187","-7059","-0.5","32.2","10105","12.5","11619","14.4","79665","7416","7445","41705","87817","138381","226198","16.1","6.3","143562","233257","89695","16.6","6.4"
"Texas","1981","4879338","235071","310890","6.4","32.2","52884","19.5","34927","12.9","291027","19810","19910","130880","500349","596194","1096543","22.5","10.3","474916","785653","310737","16.1","6.4"
"Utah","1981","416596","22649","-9","0.0","38.4","4227","15.8","4266","16.0","26560","2642","2654","16753","36675","43299","79974","19.2","8.8","46667","79983","33316","19.2","8.0"
"Vermont","1981","161293","11049","1093","0.6","29.8","1531","12.4","1681","13.6","12252","1057","1061","5075","8699","16358","25057","15.5","5.4","14641","23964","9323","14.9","5.8"
"Virginia","1981","1586248","76139","28818","1.8","32.6","12065","12.8","13047","13.9","93322","7757","7805","46449","120522","166104","286626","18.1","7.6","147232","257808","110576","16.3","7.0"
"Washington","1981","1222439","72257","-8114","-0.6","37.8","12573","14.7","13197","15.4","84939","7886","7920","41059","97017","133502","230519","18.9","7.9","150063","238633","88570","19.5","7.2"
"West Virginia","1981","471844","26008","-8779","-1.9","29.8","3614","11.6","4368","14.1","30615","2784","2787","13077","29683","40642","70325","14.9","6.3","49880","79104","29224","16.8","6.2"
"Wisconsin","1981","1562754","78256","-51911","-3.3","26.0","9715","10.6","11341","12.4","90700","6512","6536","33536","84137","118949","203086","13.0","5.4","171996","254997","83001","16.3","5.3"
"Wyoming","1981","149044","11025","6223","4.1","41.2","2130","17.3","1889","15.3","12419","1229","1232","6489","14592","22270","36862","24.7","9.8","19170","30639","11469","20.6","7.7"
"Alabama","1982","1035586","51528","-6937","-0.7","34.2","8770","13.8","7905","12.4","63550","4763","4766","27015","73771","103713","177484","17.1","7.1","121619","184421","62802","17.8","6.1"
"Alaska","1982","118895","7770","15205","12.7","43.0","2062","23.6","1113","12.7","9202","578","581","5306","17287","23421","40708","34.2","14.5","15681","25503","9822","21.5","8.3"
"Arizona","1982","810479","44307","14690","1.8","41.8","11014","20.8","7184","13.5","54704","3976","3983","23401","97137","86571","183708","22.7","12.0","112766","169018","56252","20.9","6.9"
"Arkansas","1982","574437","34933","-1333","-0.2","34.8","6305","15.5","5165","12.7","40902","3055","3059","16426","43730","56054","99784","17.4","7.6","68029","101117","33088","17.6","5.8"
"California","1982","8361841","416159","299524","3.6","37.8","87529","17.5","63168","12.7","507962","34915","34960","231250","887957","992557","1880514","22.5","10.6","1052788","1580990","528202","18.9","6.3"
"Colorado","1982","1079447","60030","93684","8.6","36.6","13933","20.1","9428","13.6","71120","5138","5142","32193","159697","131126","290823","26.9","14.8","120423","197139","76716","18.3","7.1"
"Connecticut","1982","1250950","57543","16750","1.4","28.2","8917","13.7","6249","9.6","66275","3650","3654","22434","85654","107789","193443","15.5","6.8","125564","176693","51129","14.1","4.1"
"Delaware","1982","214437","9918","3210","1.5","25.6","1583","13.9","1181","10.4","11554","654","658","3178","13545","17065","30610","14.3","6.3","18645","27400","8755","12.8","4.1"
"District of Columbia","1982","337053","13524","-3934","-1.1","36.0","2403","15.7","1738","11.3","15582","895","899","7992","32202","28311","60513","18.0","9.6","45698","64447","18749","19.1","5.6"
"Florida","1982","3106680","185530","68036","2.2","39.6","41962","19.2","27844","12.7","224964","16531","16557","107630","330673","351960","682633","22.0","10.6","406812","614597","207785","19.8","6.7"
"Geogia","1982","1746660","82630","39406","2.3","33.8","16197","15.8","12492","12.2","103586","6854","6859","42263","164650","169922","334572","19.2","9.4","196976","295166","98190","16.9","5.6"
"Hawaii","1982","311254","17274","5797","1.8","35.2","3292","15.9","2380","11.5","21094","1355","1355","8406","33667","26867","60534","19.4","10.8","35855","54737","18882","17.6","6.1"
"Idaho","1982","249562","16468","-12884","-5.1","42.4","3163","16.3","2591","13.4","19544","1409","1410","7452","33498","19320","52818","21.2","13.4","49931","65702","15771","26.3","6.3"
"Illinois","1982","3926601","174328","-69881","-1.8","31.0","28342","13.8","22357","10.9","207478","12810","12830","79738","289970","317634","607604","15.5","7.4","471106","677485","206379","17.3","5.3"
"Indiana","1982","1722512","78792","-35880","-2.1","27.6","12672","13.2","10134","10.5","97057","6026","6046","33864","104209","133352","237561","13.8","6.0","197304","273441","76137","15.9","4.4"
"Iowa","1982","862235","52350","12424","1.4","33.6","7812","12.4","7275","11.5","62933","4286","4287","20707","65929","91084","157013","18.2","7.6","99316","144589","45273","16.8","5.3"
"Kansas","1982","741914","45119","10172","1.4","32.8","7796","14.7","6269","11.8","53521","3726","3748","22239","57443","74702","132145","17.8","7.7","78239","121973","43734","16.4","5.9"
"Kentucky","1982","938637","50098","12059","1.3","33.0","8804","14.8","6926","11.6","60158","4166","4169","21752","76129","91109","167238","17.8","8.1","107959","155179","47220","16.5","5.0"
"Louisiana","1982","1297744","65758","37440","2.9","37.0","13262","17.1","8662","11.2","79316","4922","4939","38950","115912","161691","277603","21.4","8.9","157381","240163","82782","18.5","6.4"
"Maine","1982","312392","19071","2982","1.0","32.4","3004","13.6","2481","11.2","22254","1444","1451","9929","23931","29712","53643","17.2","7.7","31236","50661","19425","16.2","6.2"
"Maryland","1982","1269528","60832","18185","1.4","33.0","10849","14.9","7703","10.6","74008","4264","4266","26947","104776","122608","227384","17.9","8.3","144246","209199","64953","16.5","5.1"
"Massachusetts","1982","2299675","98088","51266","2.3","27.2","15237","13.4","10541","9.3","115290","5950","5956","41290","151188","213405","364593","15.9","6.6","219652","313327","93675","13.6","4.1"
"Michigan","1982","2686353","122650","-102197","-3.8","28.2","20280","13.6","16693","11.2","150153","9214","9227","55876","164916","214389","379305","14.1","6.1","334639","481502","146863","17.9","5.5"
"Minnesota","1982","1443395","68678","-18448","-1.2","31.6","10889","13.4","8522","10.5","82181","4801","4811","28508","96515","131025","227540","15.8","6.7","176255","245988","69733","17.0","4.8"
"Mississippi","1982","589624","34671","-11690","-2.0","29.8","5936","14.3","5006","12.1","41638","2957","2959","14331","41851","46227","88078","14.9","7.1","66704","99768","33064","16.9","5.6"
"Missouri","1982","1633451","78840","45315","2.7","31.8","13306","14.0","11294","11.9","95517","6521","6540","37397","155239","149190","304429","18.6","9.5","172703","259114","86411","15.9","5.3"
"Montana","1982","198950","17059","1140","0.6","40.2","3054","15.6","2501","12.8","19628","1433","1436","8010","20141","20980","41121","20.7","10.1","26328","39981","13653","20.1","6.9"
"Nebraska","1982","480356","30581","-4569","-1.0","31.2","4735","13.3","3890","10.9","35790","2348","2351","12182","34441","40574","75015","15.6","7.2","54627","79584","24957","16.6","5.2"
"Nevada","1982","335154","15935","6297","1.9","42.0","3692","20.3","2505","13.8","18664","1405","1406","10635","38523","38090","76613","22.9","11.5","46812","70316","23504","21.0","7.0"
"New Hampshire","1982","326759","17903","6518","2.0","29.2","3047","15.2","2178","10.9","20303","1280","1281","8359","22836","31526","54362","16.6","7.0","31062","47844","16782","14.6","5.1"
"New Jersey","1982","2548151","131665","50068","1.9","32.0","20644","13.8","15539","10.4","151014","8811","8820","50131","176682","280019","456701","17.9","6.9","266020","406633","140613","16.0","5.5"
"New Mexico","1982","334673","22552","11588","3.5","36.8","4549","17.4","3231","12.4","26589","1887","1887","11252","33842","39472","73314","21.9","10.1","38615","61726","23111","18.4","6.9"
"New York","1982","5902562","310148","137348","2.4","29.8","46816","13.4","36881","10.5","353411","22083","22112","130311","426999","592132","1019131","17.3","7.2","585159","881783","296624","14.9","5.0"
"North Carolina","1982","1968928","88660","17990","0.9","29.2","15526","14.3","11811","10.9","109820","7290","7305","39094","141191","163356","304547","15.5","7.2","195563","286557","90994","14.6","4.6"
"North Dakota","1982","171412","13516","5189","3.0","30.4","2209","14.2","1713","11.0","15679","983","984","5189","13945","17298","31243","18.2","8.1","17279","26054","8775","15.2","5.1"
"Ohio","1982","3506120","150716","-58156","-1.7","29.4","24446","12.8","20170","10.6","191602","10913","10930","66014","225909","290388","516297","14.7","6.4","410156","574453","164297","16.4","4.7"
"Oklahoma","1982","947988","55975","62635","6.6","34.0","12114","18.9","7613","11.9","66082","4621","4623","28930","97440","126243","223683","23.6","10.3","103160","161048","57888","17.0","6.1"
"Oregon","1982","784462","49241","-17067","-2.1","39.0","9608","16.4","8931","15.3","58378","4952","4970","27160","75413","77310","152723","19.5","9.6","113668","169790","56122","21.6","7.2"
"Pennsylvania","1982","3945137","170926","-17539","-0.4","31.2","26202","12.6","20407","9.8","209563","11471","11502","71537","255840","358865","614705","15.6","6.5","446699","632244","185545","16.0","4.7"
"Rhode Island","1982","331141","17894","-4402","-1.3","28.6","2462","12.4","2061","10.3","20031","1205","1206","7347","20312","26895","47207","14.3","6.1","36363","51609","15246","15.6","4.6"
"South Carolina","1982","922082","43950","6556","0.7","31.6","8233","15.5","6102","11.5","53821","3772","3776","23598","74337","77914","152251","16.5","8.1","101629","145695","44066","15.8","4.8"
"South Dakota","1982","167378","13678","-207","-0.1","32.8","1951","12.4","1742","11.1","15664","1050","1051","5099","13079","14303","27382","16.4","7.8","18354","27589","9235","16.5","5.5"
"Tennessee","1982","1394634","66172","-8853","-0.7","32.8","12316","15.3","9901","12.3","81133","5818","5825","34291","110897","118238","229135","16.4","8.0","166400","237988","71588","17.1","5.1"
"Texas","1982","5202200","247519","355607","6.9","34.6","58523","19.4","34608","11.5","312446","20275","20292","141169","582424","675553","1257977","24.2","11.2","586736","902370","315634","17.3","6.1"
"Utah","1982","420674","22985","8982","2.2","35.8","4842","17.9","3523","13.0","27573","1980","1980","13106","38779","45661","84440","20.1","9.2","48792","75458","26666","17.9","6.3"
"Vermont","1982","162040","11298","940","0.6","30.8","1891","15.2","1340","10.8","12644","790","803","4287","10823","15092","25915","16.0","6.7","15961","24975","9014","15.4","5.6"
"Virginia","1982","1614790","76933","23113","1.5","33.8","14270","15.1","10560","11.1","96007","6049","6053","35442","120466","176266","296732","18.4","7.5","193550","273619","80069","16.9","5.0"
"Washington","1982","1210293","73192","-14136","-1.2","37.0","14841","17.2","10965","12.7","87671","6136","6158","34735","110239","113466","223705","18.5","9.1","165530","237841","72311","19.7","6.0"
"West Virginia","1982","464766","25339","-3032","-0.7","32.6","4211","13.8","3816","12.5","30396","2184","2185","12243","33940","41867","75807","16.3","7.3","50929","78839","27910","17.0","6.0"
"Wisconsin","1982","1533863","78176","1888","0.1","29.2","11980","13.1","9241","10.1","92160","5364","5373","28417","102851","122403","225254","14.7","6.7","158276","223366","65090","14.6","4.2"
"Wyoming","1982","156246","11398","9152","5.9","42.8","2489","19.5","1681","13.2","13087","981","981","5404","23952","18639","42591","27.3","15.3","22516","33439","10923","21.4","7.0"
"Alabama","1983","1008350","52559","-19944","-2.0","33.4","7818","12.2","7383","11.5","64548","4861","4884","28672","68404","99914","168318","16.7","6.8","124541","188262","63721","18.7","6.3"
"Alaska","1983","128659","8798","3249","2.5","50.0","2259","23.1","1221","12.5","10380","757","757","4841","15783","19577","35360","27.5","12.3","21451","32111","10660","25.0","8.3"
"Arizona","1983","822756","46545","22638","2.8","39.6","9435","16.9","7192","12.9","57195","4743","4763","29774","80718","105070","185788","22.6","9.8","109177","163150","53973","19.8","6.6"
"Arkansas","1983","570494","35923","2876","0.5","32.0","5448","13.2","4814","11.6","41871","3353","3361","16481","37684","56652","94336","16.5","6.6","62140","91460","29320","16.0","5.1"
"California","1983","8321084","426462","-287181","-3.4","37.6","70793","13.8","63438","12.4","517992","39906","40136","249852","599820","960712","1560532","18.8","7.2","1283503","1847713","564210","22.2","6.8"
"Colorado","1983","1088757","62282","-51298","-4.7","38.8","11852","16.4","9693","13.4","73644","6409","6438","37759","93647","117553","211200","19.4","8.6","189964","262498","72534","24.1","6.7"
"Connecticut","1983","1261708","59291","3023","0.2","30.0","7543","11.2","6203","9.2","68139","4048","4055","21376","61693","130402","192095","15.2","4.9","136825","189072","52247","15.0","4.1"
"Delaware","1983","216723","10295","1036","0.5","29.4","1439","12.3","1171","10.0","11941","710","715","4373","13261","19629","32890","15.2","6.1","21591","31854","10263","14.7","4.7"
"District of Columbia","1983","347245","14133","27764","8.0","28.8","2028","12.8","1581","10.0","16174","963","965","6655","19080","58607","77687","22.4","5.5","34482","49923","15441","14.4","4.4"
"Florida","1983","3139059","190507","10577","0.3","39.4","36827","16.2","31999","14.0","230989","19819","19900","117227","274794","353448","628242","20.0","8.8","384472","617665","233193","19.7","7.4"
"Geogia","1983","1761597","86232","17393","1.0","34.6","14892","14.1","11578","11.0","107526","7611","7628","45682","129884","192752","322636","18.3","7.4","205284","305243","99959","17.3","5.7"
"Hawaii","1983","313054","17978","-4279","-1.4","34.2","2793","13.0","2259","10.5","21839","1493","1514","9973","21579","31933","53512","17.1","6.9","39843","57791","17948","18.5","5.7"
"Idaho","1983","235298","16851","-10245","-4.4","34.8","2607","13.2","2413","12.2","19897","1604","1611","8259","16777","24190","40967","17.4","7.1","36157","51212","15055","21.8","6.4"
"Illinois","1983","3800343","171918","-168021","-4.4","27.8","22707","11.0","25620","12.4","205087","14010","14109","86046","202279","325065","527344","13.9","5.3","465990","695365","229375","18.3","6.0"
"Indiana","1983","1656094","74718","-83390","-5.1","26.4","9691","10.2","13097","13.8","92676","7057","7108","41432","74920","144495","219415","13.2","4.5","194011","302805","108794","18.3","6.6"
"Iowa","1983","832149","53389","-63734","-7.6","29.0","6400","10.1","6389","10.1","63885","4296","4306","21445","51006","69451","120457","14.5","6.1","132449","184191","51742","22.1","6.2"
"Kansas","1983","724018","46404","-32939","-4.5","31.0","6689","12.4","5902","10.9","54762","3966","3987","20525","47699","64332","112031","15.5","6.6","95748","144970","49222","20.0","6.8"
"Kentucky","1983","923725","51207","-39521","-4.3","29.4","7339","12.1","6809","11.2","61174","4613","4623","26748","55409","80831","136240","14.7","6.0","123232","175761","52529","19.0","5.7"
"Louisiana","1983","1260193","67495","-92023","-7.3","33.6","10466","13.1","9369","11.7","80869","6431","6452","46244","86100","125464","211564","16.8","6.8","212483","303587","91104","24.1","7.2"
"Maine","1983","316502","19672","5092","1.6","27.6","2679","11.9","2292","10.2","22809","1475","1478","7526","17911","30718","48629","15.4","5.7","27780","43537","15757","13.8","5.0"
"Maryland","1983","1287630","63676","12932","1.0","31.0","9547","12.7","7238","9.6","76930","4650","4677","28239","73410","138944","212354","16.5","5.7","133730","199422","65692","15.5","5.1"
"Massachusetts","1983","2331911","100925","9618","0.4","29.0","12775","10.9","10533","9.0","118300","6891","6921","46491","123386","223427","346813","14.9","5.3","237775","337195","99420","14.5","4.3"
"Michigan","1983","2630357","125642","-34996","-1.3","28.0","17284","11.4","15652","10.3","153082","9722","9780","55747","132359","236040","368399","14.0","5.0","280661","403395","122734","15.3","4.7"
"Minnesota","1983","1414329","70589","-23923","-1.6","30.4","9302","11.2","8050","9.7","84129","5104","5123","31334","82139","132154","214293","15.2","5.8","168897","238216","69319","16.8","4.9"
"Mississippi","1983","574022","35577","-2367","-0.4","32.6","5121","12.2","4724","11.2","42476","3262","3279","16513","39222","54459","93681","16.3","6.8","65681","96048","30367","16.7","5.3"
"Missouri","1983","1615228","81397","-50841","-3.1","32.0","11785","12.2","10396","10.8","97812","6682","6724","37811","101147","157050","258197","16.0","6.3","215028","309038","94010","19.1","5.8"
"Montana","1983","196569","17739","-814","-0.4","38.8","2735","13.7","2310","11.6","20302","1516","1531","8733","17462","20605","38067","19.4","8.9","25683","38881","13198","19.8","6.7"
"Nebraska","1983","470496","31505","-5386","-1.1","32.2","3923","10.8","3578","9.9","36662","2302","2312","13286","32518","43011","75529","16.1","6.9","54680","80915","26235","17.2","5.6"
"Nevada","1983","332451","16170","-11766","-3.5","34.6","2837","15.1","2678","14.3","18897","1784","1789","11403","26166","31213","57379","17.3","7.9","47303","69145","21842","20.8","6.6"
"New Hampshire","1983","332368","18710","6918","2.0","30.4","2759","13.3","2048","9.9","21156","1397","1399","8668","21021","36255","57276","17.2","6.3","34190","50358","16168","15.2","4.9"
"New Jersey","1983","2592664","135767","30821","1.2","32.0","18127","11.8","15163","9.9","155125","9895","9916","55193","156990","288766","445756","17.2","6.1","268142","414935","146793","16.0","5.7"
"New Mexico","1983","333916","23525","-1432","-0.5","41.0","4074","15.0","3327","12.3","27583","2169","2172","13358","31265","37286","68551","20.5","9.4","45213","69983","24770","21.0","7.4"
"New York","1983","5966648","318787","-9675","-0.2","32.2","41467","11.6","36329","10.2","362165","25487","25565","144363","317954","643428","961382","16.1","5.3","664794","971057","306263","16.3","5.1"
"North Carolina","1983","1951673","84963","-17298","-0.9","30.0","12413","11.5","14724","13.6","106262","8045","8088","44571","116714","175550","292264","15.0","6.0","199424","309562","110138","15.9","5.6"
"North Dakota","1983","171271","13888","-3239","-1.9","31.6","1812","11.4","1696","10.7","16016","1124","1127","6348","11346","15731","27077","15.8","6.6","19175","30316","11141","17.7","6.5"
"Ohio","1983","3429360","153324","-99444","-2.9","27.2","19593","10.2","19322","10.0","193626","11696","11777","67892","167402","298035","465437","13.6","4.9","411735","564881","153146","16.5","4.5"
"Oklahoma","1983","938901","56795","-56358","-6.0","35.8","9261","13.9","8770","13.2","66872","6372","6394","41004","73567","94545","168112","17.9","7.8","157211","224470","67259","23.9","7.2"
"Oregon","1983","756681","50079","-29677","-3.9","35.2","8048","13.7","7693","13.1","59185","4962","4991","26424","53820","79122","132942","17.6","7.1","115189","162619","47430","21.5","6.3"
"Pennsylvania","1983","3858567","175213","-156061","-4.0","27.8","21723","10.3","20017","9.5","213454","12337","12399","73810","199683","335862","535545","13.9","5.2","500872","691606","190734","17.9","4.9"
"Rhode Island","1983","330649","18301","2978","0.9","26.4","2128","10.5","1917","9.5","20378","1294","1296","6785","14197","32486","46683","14.1","4.3","29839","43705","13866","13.2","4.2"
"South Carolina","1983","906297","42225","-19597","-2.2","29.6","6290","11.9","7249","13.7","52201","4240","4254","24142","53293","81214","134507","14.8","5.9","101690","154104","52414","17.0","5.8"
"South Dakota","1983","166127","14024","-1167","-0.7","30.4","1719","10.9","1687","10.7","15956","1076","1080","5293","10540","14746","25286","15.2","6.3","17396","26453","9057","15.9","5.5"
"Tennessee","1983","1390395","68003","23776","1.7","32.0","10688","13.0","9477","11.6","82972","6328","6359","36869","99175","146803","245978","17.7","7.1","153105","222202","69097","16.0","5.0"
"Texas","1983","5235620","256749","-190595","-3.6","39.2","48407","15.3","40083","12.6","322516","26952","27194","183673","444880","579938","1024818","19.6","8.5","855968","1215413","359445","23.2","6.9"
"Utah","1983","420041","23460","-3923","-1.0","36.8","3739","13.4","3502","12.6","28098","2234","2241","13967","34207","43264","77471","18.4","8.1","55802","81394","25592","19.4","6.1"
"Vermont","1983","162155","11688","-1271","-0.8","27.4","1585","12.4","1325","10.3","13024","902","904","3849","8657","13587","22244","13.7","5.3","17245","23515","6270","14.5","3.9"
"Virginia","1983","1622507","80067","-5604","-0.3","32.0","12244","12.5","9888","10.1","99284","6442","6492","36726","91007","168440","259447","16.0","5.6","188669","265051","76382","16.3","4.7"
"Washington","1983","1210142","76292","19863","1.7","36.4","12758","14.3","10543","11.8","90803","6727","6784","36932","112306","128245","240551","19.9","9.3","153739","220688","66949","18.2","5.5"
"West Virginia","1983","443563","25750","-42099","-9.5","25.0","3385","11.1","3516","11.5","30779","2316","2320","12624","25529","30037","55566","12.5","5.8","72043","97665","25622","22.0","5.8"
"Wisconsin","1983","1514579","80231","-45547","-3.0","26.2","9617","10.3","8566","9.2","94261","5439","5461","31441","71956","126211","198167","13.1","4.8","179640","243714","64074","16.1","4.2"
"Wyoming","1983","146464","11467","-24470","-16.7","34.8","1855","14.2","1917","14.6","13117","1309","1310","7754","12989","12468","25457","17.4","8.9","37767","49927","12160","34.1","8.3"
"Alabama","1984","1040328","55138","76642","7.4","26.4","10032","15.2","7408","11.2","67233","4888","4910","28444","74882","139325","214207","20.6","7.2","81542","137565","56023","13.2","5.4"
"Alaska","1984","135862","9721","10215","7.6","40.0","2456","22.6","1459","13.4","11362","901","902","5761","16633","20813","37446","27.6","12.2","16903","27231","10328","20.0","7.6"
"Arizona","1984","886564","49990","98299","11.0","30.0","10981","18.6","7237","12.3","60964","4630","4652","27226","88592","142285","230877","26.0","10.0","82130","132578","50448","15.0","5.7"
"Arkansas","1984","591885","37626","44331","7.5","25.4","6764","15.8","4944","11.6","43722","3360","3379","16933","42642","77121","119763","20.2","7.2","44609","75432","30823","12.7","5.2"
"California","1984","8501049","444670","671403","7.8","30.0","81523","15.4","61524","11.7","537786","38298","38462","232832","683957","1258455","1942412","22.8","8.0","792115","1271009","478894","15.0","5.6"
"Colorado","1984","1095963","65539","65348","5.9","33.0","13247","17.6","9734","12.9","77255","6474","6496","35849","101925","143720","245645","22.4","9.3","113158","180297","67139","16.5","6.1"
"Connecticut","1984","1292967","61305","61553","4.8","25.0","8572","12.4","6358","9.2","70362","4186","4197","24915","74194","149587","223781","17.3","5.7","108090","162228","54138","12.5","4.2"
"Delaware","1984","223808","10613","14111","6.3","23.8","1626","13.4","1297","10.7","12270","779","782","3757","13713","26921","40634","18.2","6.1","16884","26523","9639","11.9","4.3"
"District of Columbia","1984","353491","13793","-12942","-3.6","32.0","1873","11.7","2071","12.9","15913","1173","1173","6855","19600","36809","56409","16.0","5.5","51345","69351","18006","19.6","5.1"
"Florida","1984","3320817","204982","346077","10.4","29.8","44838","18.8","28709","12.0","247109","19564","19669","108460","356722","482898","839620","25.3","10.7","296046","493543","197497","14.9","5.9"
"Geogia","1984","1852078","90975","163266","8.9","24.4","17152","15.6","11954","10.8","112875","7527","7556","45174","142143","247778","389921","21.1","7.7","135443","226655","91212","12.2","4.9"
"Hawaii","1984","310797","17969","25","0.0","31.6","2526","11.6","2523","11.6","21828","1549","1581","8836","18100","31053","49153","15.8","5.8","31546","49128","17582","15.8","5.7"
"Idaho","1984","239238","17361","17774","7.4","28.8","2870","14.2","2292","11.4","20481","1562","1565","8122","17990","34175","52165","21.8","7.5","20832","34391","13559","14.4","5.7"
"Illinois","1984","3851622","180753","246251","6.4","24.0","27776","13.2","19475","9.3","214659","10288","10338","52728","237850","472367","710217","18.4","6.2","299581","463966","164385","12.0","4.3"
"Indiana","1984","1684517","82032","125222","7.4","22.8","12219","12.7","6396","6.6","100417","154","177","1833","110863","205930","316793","18.8","6.6","123948","191571","67623","11.4","4.0"
"Iowa","1984","813190","54248","26940","3.4","27.0","7685","11.9","6643","10.3","64905","4428","4440","20054","51683","85343","137026","16.9","6.4","72547","110086","37539","13.5","4.6"
"Kansas","1984","742495","47008","68597","9.3","28.2","7850","14.2","7105","12.9","55572","4155","4165","22608","53604","119801","173405","23.4","7.2","59281","104808","45527","14.1","6.1"
"Kentucky","1984","926022","52680","41829","4.5","26.6","8716","14.1","7019","11.3","62833","4725","4734","27193","61879","102755","164634","17.8","6.7","74370","122805","48435","13.3","5.2"
"Louisiana","1984","1226034","68750","17855","1.4","34.6","11552","14.1","9918","12.1","82544","6603","6629","36860","89425","140358","229783","18.7","7.3","138054","211928","73874","17.3","6.0"
"Maine","1984","327997","20624","19425","5.9","22.6","3324","14.3","2223","9.5","23857","1444","1452","6650","19436","37100","56536","17.2","5.9","24009","37111","13102","11.3","4.0"
"Maryland","1984","1335248","63699","90883","6.8","25.6","9621","12.5","9056","11.7","77363","5195","5214","30943","98263","163700","261963","19.6","7.4","100098","171080","70982","12.8","5.3"
"Massachusetts","1984","2430899","104727","165131","6.7","23.0","14760","12.3","10642","8.8","122586","6883","6898","41653","139131","304485","443616","18.2","5.7","186557","278485","91928","11.5","3.8"
"Michigan","1984","2682072","130947","215463","8.0","22.2","20564","13.2","15346","9.8","158621","9657","9713","51279","158996","354422","513418","19.1","5.9","171329","297955","126626","11.1","4.7"
"Minnesota","1984","1456843","73463","107277","7.4","24.6","11483","13.4","8475","9.9","87209","5380","5429","32224","98644","188139","286783","19.7","6.8","109425","179506","70081","12.3","4.8"
"Mississippi","1984","592868","36901","41328","6.9","25.0","6232","14.4","4867","11.3","43906","3259","3270","14956","41264","73916","115180","19.4","7.0","43661","73852","30191","12.5","5.1"
"Missouri","1984","1652924","83049","89968","5.4","27.0","13227","13.4","11513","11.6","99775","7251","7280","42204","111525","201047","312572","18.9","6.7","139910","222604","82694","13.5","5.0"
"Montana","1984","198664","18551","5294","2.7","33.0","3215","15.5","2377","11.5","21143","1552","1555","6989","15372","22766","38138","19.2","7.7","21137","32844","11707","16.5","5.9"
"Nebraska","1984","476473","31279","4249","0.9","30.6","4242","11.6","4368","11.9","36541","2538","2550","12842","29588","47733","77321","16.2","6.2","45890","73072","27182","15.3","5.7"
"Nevada","1984","343825","17171","35526","10.3","27.8","3528","18.1","2413","12.4","20005","1581","1581","9125","28885","54468","83353","24.2","8.4","27768","47827","20059","13.9","5.8"
"New Hampshire","1984","350221","19940","41439","11.8","22.2","3475","15.9","2147","9.8","22503","1426","1431","7893","29749","50474","80223","22.9","8.5","22467","38784","16317","11.1","4.7"
"New Jersey","1984","2680205","139819","153701","5.7","26.6","20007","12.7","15534","9.9","159770","10004","10026","54110","179469","330587","510056","19.0","6.7","231012","356355","125343","13.3","4.7"
"New Mexico","1984","343775","24339","17996","5.3","33.8","4472","16.0","3567","12.7","28441","2361","2366","12325","32475","43729","76204","22.2","9.4","37149","58208","21059","16.9","6.1"
"New York","1984","6097225","325043","220463","3.7","27.4","44945","12.3","38364","10.5","368867","26257","26302","161909","371141","687512","1058653","17.4","6.1","551347","838190","286843","13.7","4.7"
"North Carolina","1984","2037736","97433","194052","9.5","19.0","17575","15.6","6616","5.9","119472","230","239","1749","127451","260398","387849","19.0","6.3","138184","193797","55613","9.5","2.7"
"North Dakota","1984","172112","14104","4364","2.5","29.4","2072","12.8","1820","11.3","16305","1054","1057","5056","12192","17412","29604","17.2","7.1","15344","25240","9896","14.7","5.7"
"Ohio","1984","3475636","158035","187902","5.4","23.4","23392","11.9","18807","9.6","198456","11407","11499","56969","193324","401571","594895","17.1","5.6","271543","406993","135450","11.7","3.9"
"Oklahoma","1984","914544","58091","3468","0.4","37.0","10470","15.5","8775","13.0","68485","6210","6219","33190","73247","99534","172781","18.9","8.0","107864","169313","61449","18.5","6.7"
"Oregon","1984","765430","52482","47658","6.2","29.2","9596","15.9","7060","11.7","61768","4722","4733","22430","56851","102598","159449","20.8","7.4","70771","111791","41020","14.6","5.4"
"Pennsylvania","1984","3867472","178940","177832","4.6","25.0","25281","11.7","21212","9.8","217598","12917","12986","76271","220049","440985","661034","17.1","5.7","307716","483202","175486","12.5","4.5"
"Rhode Island","1984","342904","18812","19642","5.8","23.2","2511","12.2","1985","9.6","20883","1323","1327","6390","19241","40335","59576","17.4","5.6","26254","39934","13680","11.6","4.0"
"South Carolina","1984","939565","47764","78226","8.4","21.4","8610","15.6","3834","7.0","58091","127","130","1221","68034","111169","179203","19.1","7.2","67759","100977","33218","10.7","3.5"
"South Dakota","1984","170357","14276","9589","5.6","26.4","2157","13.4","1865","11.6","16261","1067","1069","4851","11763","20308","32071","18.8","6.9","12847","22482","9635","13.2","5.7"
"Tennessee","1984","1448024","71061","83291","5.8","27.2","13068","15.4","9755","11.5","86278","6436","6470","35131","102570","178353","280923","19.4","7.1","124729","197632","72903","13.6","5.0"
"Texas","1984","5266633","264132","243396","4.7","35.0","52188","16.0","42659","13.0","331867","27900","28024","172149","499978","667167","1167145","22.2","9.5","583730","923749","340019","17.5","6.5"
"Utah","1984","433613","24402","30984","7.2","28.0","4423","15.5","3364","11.8","29152","2145","2146","12195","33790","58089","91879","21.2","7.8","37357","60895","23538","14.0","5.4"
"Vermont","1984","166945","12300","12043","7.2","22.0","2007","15.0","1327","9.9","13680","899","901","4290","11373","19018","30391","18.2","6.8","10924","18348","7424","11.0","4.4"
"Virginia","1984","1654170","78723","97857","5.9","26.2","13549","13.7","13608","13.8","98417","7052","7075","41773","110148","204156","314304","19.0","6.7","118818","216447","97629","13.1","5.9"
"Washington","1984","1252889","80717","70078","5.6","31.0","15169","16.3","10501","11.3","95533","6911","6919","35792","100305","163470","263775","21.1","8.0","125764","193697","67933","15.5","5.4"
"West Virginia","1984","422005","24683","4723","1.1","30.8","3698","12.2","4520","14.9","29710","2264","2269","11559","25610","43944","69554","16.5","6.1","34716","64831","30115","15.4","7.1"
"Wisconsin","1984","1538756","82663","94353","6.1","23.2","11883","12.4","9210","9.6","96931","5804","5824","28489","89318","182944","272262","17.7","5.8","113524","177909","64385","11.6","4.2"
"Wyoming","1984","134617","11517","-127","-0.1","41.8","1921","14.6","1840","14.0","13197","1145","1148","5522","13622","14505","28127","20.9","10.1","17708","28254","10546","21.0","7.8"
"Alabama","1985","1113206","56904","37640","3.4","29.0","9620","14.1","7859","11.5","69263","5158","5188","32391","71006","128462","199468","17.9","6.4","99374","161828","62454","14.5","5.6"
"Alaska","1985","149452","10189","8403","5.6","43.6","2350","20.2","1803","15.5","11923","1175","1180","6156","16780","24148","40928","27.4","11.2","18386","32525","14139","21.8","9.5"
"Arizona","1985","997245","53291","101476","10.2","32.0","11646","18.5","7977","12.7","64612","5215","5248","37122","96757","164248","261005","26.2","9.7","90049","159529","69480","16.0","7.0"
"Arkansas","1985","650439","38828","14181","2.1","30.4","6148","13.8","5289","11.9","44972","3690","3725","21256","41362","71372","112734","17.3","6.4","56489","98553","42064","15.2","6.5"
"California","1985","9081292","463300","356349","3.9","34.6","83652","15.3","65019","11.9","556699","39811","40076","282553","709752","1214044","1923796","21.2","7.8","948036","1567447","619411","17.3","6.8"
"Colorado","1985","1146241","67414","31873","2.7","35.8","13226","16.9","11071","14.1","79441","7465","7490","48116","99309","137286","236595","20.6","8.7","119096","204722","85626","17.9","7.5"
"Connecticut","1985","1361371","63242","49437","3.6","25.0","9007","12.6","6959","9.7","72502","4630","4643","29287","65510","154344","219854","16.1","4.8","105615","170417","64802","12.5","4.8"
"Delaware","1985","239484","11023","11813","4.9","25.8","1744","13.9","1279","10.2","12733","768","770","4629","13291","29433","42724","17.8","5.5","19718","30911","11193","12.9","4.7"
"District of Columbia","1985","355228","14275","15824","4.5","28.2","1961","12.1","1472","9.1","16470","423","434","6255","23434","42481","65915","18.6","6.6","28859","50091","21232","14.1","6.0"
"Florida","1985","3602407","215201","188976","5.2","35.0","44981","17.8","32388","12.8","259414","22027","22110","139888","339836","477917","817753","22.7","9.4","375367","628777","253410","17.5","7.0"
"Geogia","1985","2029062","96305","139354","6.8","27.6","18304","15.8","12568","10.8","118783","7867","7916","48801","150247","268751","418998","20.6","7.4","170172","279644","109472","13.8","5.4"
"Hawaii","1985","316038","18464","10127","3.2","28.8","2927","13.2","2324","10.5","22379","1464","1476","7705","22258","33270","55528","17.6","7.0","28233","45401","17168","14.4","5.4"
"Idaho","1985","251095","17732","-1290","-0.6","34.8","2778","13.4","2477","11.9","20897","1631","1640","9030","16149","27635","43784","17.4","6.4","29731","45074","15343","18.0","6.1"
"Illinois","1985","4066985","184677","62527","1.5","29.2","26119","12.0","23133","10.6","218917","14716","14800","98206","237784","418585","656369","16.1","5.8","372486","593842","221356","14.6","5.4"
"Indiana","1985","1798119","84537","39916","2.2","27.0","12823","12.6","10765","10.6","103018","6795","6827","43382","108879","173962","282841","15.7","6.1","152528","242925","90397","13.5","5.0"
"Iowa","1985","848464","53774","4074","0.5","28.0","6627","10.2","7423","11.5","64326","4928","4947","25370","42561","80383","122944","14.5","5.0","70090","118870","48780","14.0","5.7"
"Kansas","1985","791169","48789","-4416","-0.6","34.4","7935","14.0","6271","11.1","57371","4116","4134","25739","55539","80652","136191","17.2","7.0","70249","140607","70358","17.8","8.9"
"Kentucky","1985","1017819","54185","39454","3.8","25.6","8038","12.6","7040","11.0","64346","4787","4816","26351","60758","108651","169409","16.6","6.0","76916","129955","53039","12.8","5.2"
"Louisiana","1985","1245248","69542","2348","0.2","35.6","11200","13.5","10257","12.3","83464","6828","6865","41109","89005","134603","223608","18.0","7.1","139376","221260","81884","17.8","6.6"
"Maine","1985","344999","21796","5329","1.6","30.2","3486","14.2","2480","10.1","25031","1569","1573","9282","22041","35422","57463","16.7","6.4","29426","52134","22708","15.1","6.6"
"Maryland","1985","1432958","68487","101725","7.1","27.4","11566","14.5","6610","8.3","82601","2356","2387","22239","108579","188913","297492","20.8","7.6","125030","195767","70737","13.7","4.9"
"Massachusetts","1985","2563071","108631","92674","3.6","27.2","15964","12.8","11616","9.3","126964","7531","7560","61149","134401","306544","440945","17.2","5.2","218811","348271","129460","13.6","5.1"
"Michigan","1985","2853139","135239","128824","4.5","27.6","20943","13.0","16236","10.1","163398","10581","10639","64455","205232","317436","522668","18.3","7.2","221346","393844","172498","13.8","6.0"
"Minnesota","1985","1558560","75220","54743","3.5","28.6","11258","12.7","9535","10.8","89172","6197","6229","53948","105570","171341","276911","17.8","6.8","125325","222168","96843","14.3","6.2"
"Mississippi","1985","652421","37585","12187","1.8","29.4","5853","13.2","5147","11.6","44765","3459","3476","18729","40183","67671","107854","16.5","6.2","58588","95667","37079","14.7","5.7"
"Missouri","1985","1746317","86028","41378","2.4","28.6","13853","13.6","11055","10.9","103004","7284","7320","45636","110782","180517","291299","16.7","6.3","140809","249921","109112","14.3","6.2"
"Montana","1985","218380","19069","-1627","-0.7","32.4","2930","13.6","2745","12.8","21604","1817","1820","8384","13882","21501","35383","16.2","6.4","20930","37010","16080","16.9","7.4"
"Nebraska","1985","503877","32820","14121","2.8","27.8","4739","12.6","3896","10.3","38078","2600","2611","16595","36522","47737","84259","16.7","7.2","38562","70138","31576","13.9","6.3"
"Nevada","1985","369360","17603","14448","3.9","31.6","3347","16.5","2865","14.2","20476","1891","1896","13367","28701","44186","72887","19.7","7.8","30265","58439","28174","15.8","7.6"
"New Hampshire","1985","400410","21587","21650","5.4","28.6","3935","16.7","2410","10.3","24277","1596","1600","11110","27986","51048","79034","19.7","7.0","34340","57384","23044","14.3","5.8"
"New Jersey","1985","2849019","145125","114220","4.0","29.0","21816","13.4","16267","10.0","165701","10716","10757","67457","171396","354730","526126","18.5","6.0","257075","411906","154831","14.5","5.4"
"New Mexico","1985","373694","24968","14462","3.8","34.8","4372","15.2","3717","12.9","29077","2390","2399","14315","30388","48960","79348","21.2","8.1","35416","64886","29470","17.4","7.9"
"New York","1985","6318865","333438","178675","2.8","27.4","47735","12.8","39210","10.5","378095","27169","27278","161653","342997","699138","1042135","16.5","5.4","529678","863460","333782","13.7","5.3"
"North Carolina","1985","2208228","102134","76987","3.5","26.2","17424","14.3","12491","10.2","124671","7985","8014","46028","132590","234279","366869","16.6","6.0","188976","289882","100906","13.1","4.6"
"North Dakota","1985","188080","14661","3988","2.1","27.6","2057","12.3","1784","10.7","16858","1146","1148","5569","11633","18233","29866","15.9","6.2","16128","25878","9750","13.8","5.2"
"Ohio","1985","3617237","161193","134156","3.7","25.8","23196","11.6","20025","10.0","201446","12393","12496","85682","176659","422573","599232","16.6","4.9","272783","465076","192293","12.9","5.3"
"Oklahoma","1985","956124","58653","-2235","-0.3","33.4","9748","14.1","9449","13.7","69184","6612","6630","35246","65611","94507","160118","16.7","6.9","99361","162353","62992","17.0","6.6"
"Oregon","1985","822548","53735","22712","2.7","33.0","9128","14.6","8219","13.1","62941","5457","5498","30667","60129","98049","158178","19.2","7.3","78761","135466","56705","16.5","6.9"
"Pennsylvania","1985","3992309","182765","49885","1.2","28.4","26007","11.8","22225","10.1","221542","13621","13722","114415","216878","398263","615141","15.4","5.4","334873","565256","230383","14.2","5.8"
"Rhode Island","1985","356688","19383","7135","2.0","26.6","2688","12.7","2095","9.9","21512","1436","1437","10414","17115","37574","54689","15.3","4.8","30744","47554","16810","13.3","4.7"
"South Carolina","1985","1012828","50222","38081","3.7","28.6","8858","14.9","6269","10.5","60919","4133","4146","26753","67964","114607","182571","18.0","6.7","91688","144490","52802","14.3","5.2"
"South Dakota","1985","189598","14861","6268","3.3","27.0","2183","13.1","1739","10.4","16857","1103","1109","5409","14062","17796","31858","16.8","7.4","16259","25590","9331","13.5","4.9"
"Tennessee","1985","1541644","73597","59155","3.8","27.0","12390","14.1","9892","11.3","89144","6499","6551","36716","96778","170238","267016","17.3","6.3","126442","207861","81419","13.5","5.3"
"Texas","1985","5484012","273940","169913","3.1","35.4","53231","15.8","41813","12.4","343120","26856","27037","180343","471006","669689","1140695","20.8","8.6","598711","970782","372071","17.7","6.8"
"Utah","1985","459964","24879","18610","4.1","30.2","4424","15.0","3954","13.4","29637","2573","2584","16124","32749","55421","88170","19.2","7.1","41632","69560","27928","15.1","6.1"
"Vermont","1985","186234","13196","5551","2.9","26.6","2121","14.9","1463","10.3","14589","974","975","4559","11173","19057","30230","16.2","6.0","14033","24679","10646","13.3","5.7"
"Virginia","1985","1795831","88347","107671","6.0","25.0","15583","15.0","6346","6.1","108858","297","341","7925","129207","202702","331909","18.5","7.2","152567","224238","71671","12.5","4.0"
"Washington","1985","1331499","82898","39965","3.0","32.6","14324","14.8","12187","12.6","97878","7833","7885","44795","100367","156972","257339","19.3","7.5","132645","217374","84729","16.3","6.4"
"West Virginia","1985","439735","26913","8435","1.9","26.2","3885","12.6","2239","7.2","31939","132","139","1293","29136","36995","66131","15.0","6.6","40813","57696","16883","13.1","3.8"
"Wisconsin","1985","1593803","84433","30256","1.9","25.8","11583","11.8","9533","9.7","98765","6416","6466","40560","82109","153419","235528","14.8","5.2","123061","205272","82211","12.9","5.2"
"Wyoming","1985","136316","11610","-269","-0.2","38.4","1863","14.1","1810","13.7","13269","1172","1174","6200","10909","15228","26137","19.2","8.0","15725","26406","10681","19.4","7.8"
"Alabama","1986","1157441","58637","54850","4.8","29.6","10412","14.8","7918","11.3","71456","5302","5326","33580","86524","139901","226425","19.6","7.5","110416","171575","61159","14.8","5.3"
"Alaska","1986","150114","10332","-4697","-3.2","45.4","2279","19.0","2059","17.2","12056","1314","1314","7233","15613","18495","34108","22.7","10.4","24755","38805","14050","25.9","9.4"
"Arizona","1986","1074830","56018","55732","5.2","38.2","12286","18.5","8632","13.0","67984","5788","5795","41667","115495","145392","260887","24.3","10.7","129808","205155","75347","19.1","7.0"
"Arkansas","1986","671833","39347","30603","4.5","29.8","6172","13.6","5405","11.9","45527","3776","3794","20445","50602","79937","130539","19.4","7.5","62077","99936","37859","14.9","5.6"
"California","1986","9425326","481361","360331","3.8","35.2","92023","16.2","68261","12.0","578182","42785","42884","298844","830797","1190829","2021626","21.4","8.8","1051057","1661295","610238","17.6","6.5"
"Colorado","1986","1173451","68458","25661","2.2","38.6","13382","16.7","11491","14.3","80975","7643","7663","51905","115574","136429","252003","21.5","9.8","132455","226342","93887","19.3","8.0"
"Connecticut","1986","1404785","65664","38855","2.8","26.8","9977","13.5","7109","9.6","75134","4640","4646","34398","91312","135669","226981","16.2","6.5","124038","188126","64088","13.4","4.6"
"Delaware","1986","257420","11624","26575","10.3","28.8","2016","15.4","1288","9.9","13418","793","794","4447","34404","29291","63695","24.7","13.4","24791","37120","12329","14.4","4.8"
"District of Columbia","1986","381871","14629","9359","2.5","29.6","2148","12.9","1643","9.8","16930","980","983","7295","27713","38187","65900","17.3","7.3","38967","56541","17574","14.8","4.6"
"Florida","1986","3787502","225869","191622","5.0","35.6","47591","17.9","34112","12.8","271892","23278","23310","147051","378888","486324","865212","22.8","10.0","413772","673590","259818","17.8","6.9"
"Geogia","1986","2152526","100749","110703","5.2","29.8","19719","16.2","13765","11.3","124204","8758","8764","56258","170234","262060","432294","20.1","7.9","195489","321591","126102","14.9","5.9"
"Hawaii","1986","331213","18958","20718","6.2","27.8","3021","13.3","2311","10.2","23003","1500","1500","7798","26290","40342","66632","20.1","7.9","29907","45914","16007","13.9","4.8"
"Idaho","1986","252742","18051","5564","2.2","31.6","2856","13.6","2418","11.5","21219","1555","1560","8338","17495","28038","45533","18.0","6.9","26561","39969","13408","15.8","5.3"
"Illinois","1986","4152086","188829","119916","2.9","28.0","27683","12.5","22205","10.0","223773","14131","14169","98903","271223","429619","700842","16.9","6.5","368962","580926","211964","14.0","5.1"
"Indiana","1986","1844133","86853","64018","3.5","26.2","13502","12.9","10408","10.0","105751","6855","6886","45431","122581","182789","305370","16.6","6.6","155498","241352","85854","13.1","4.7"
"Iowa","1986","857244","53517","16996","2.0","28.4","6866","10.7","6962","10.9","63999","4626","4626","24197","56260","82260","138520","16.2","6.6","76669","121524","44855","14.2","5.2"
"Kansas","1986","796104","48881","16943","2.1","31.0","7318","12.7","6866","12.0","57567","4727","4753","24706","59344","81132","140476","17.6","7.5","75434","123533","48099","15.5","6.0"
"Kentucky","1986","1057476","55355","43574","4.1","26.0","8494","13.1","6839","10.5","65776","4717","4731","27903","71683","109128","180811","17.1","6.8","87790","137237","49447","13.0","4.7"
"Louisiana","1986","1233080","69072","-22135","-1.8","36.0","11060","13.3","10891","13.1","83237","7528","7542","45764","96930","124875","221805","18.0","7.9","160330","243940","83610","19.8","6.8"
"Maine","1986","356264","23017","16650","4.7","27.2","4015","15.6","2640","10.3","26308","1709","1726","9632","25179","39923","65102","18.3","7.1","29274","48452","19178","13.6","5.4"
"Maryland","1986","1523191","72479","84829","5.6","30.4","13117","15.5","8401","9.9","87147","5197","5320","38822","127820","188892","316712","20.8","8.4","148104","231883","83779","15.2","5.5"
"Massachusetts","1986","2641146","112759","74141","2.8","30.4","17767","13.7","12637","9.8","131643","8085","8108","67383","181683","294163","475846","18.0","6.9","259314","401705","142391","15.2","5.4"
"Michigan","1986","3003004","138451","173641","5.7","25.2","21763","13.2","17202","10.4","167450","11282","11304","71744","203717","346884","550601","18.3","6.8","236673","376960","140287","12.6","4.7"
"Minnesota","1986","1602486","76442","37766","2.3","30.8","11606","12.9","9804","10.9","90673","6194","6221","47610","103362","180510","283872","17.7","6.5","154493","246106","91613","15.4","5.7"
"Mississippi","1986","672467","38325","29281","4.3","29.8","6083","13.5","4997","11.1","45637","3274","3287","19813","46289","83052","129341","19.2","6.9","63404","100060","36656","14.9","5.5"
"Missouri","1986","1800448","89489","71017","4.0","28.6","14609","13.9","10330","9.8","107047","6064","6104","42371","131510","197214","328724","18.3","7.3","164171","257707","93536","14.3","5.2"
"Montana","1986","216491","19052","-2347","-1.1","33.0","2969","13.7","2817","13.0","21621","1920","1922","9412","15503","20232","35735","16.5","7.2","23360","38082","14722","17.6","6.8"
"Nebraska","1986","514435","32836","7447","1.4","28.8","4143","10.9","3982","10.5","38099","2578","2585","13579","35585","45776","81361","15.8","6.9","48912","73914","25002","14.4","4.9"
"Nevada","1986","385468","18216","18694","4.9","32.6","3665","17.6","2889","13.9","21170","1917","1918","14199","34843","46701","81544","21.2","9.0","34285","62850","28565","16.3","7.4"
"New Hampshire","1986","422210","23372","22243","5.2","31.2","4736","18.7","2648","10.5","26275","1790","1792","12060","37930","49968","87898","20.8","9.0","37453","65655","28202","15.6","6.7"
"New Jersey","1986","2944309","150356","84070","2.9","31.8","23678","14.1","17618","10.5","171239","11489","11516","70144","214193","339494","553687","18.8","7.3","309238","469617","160379","15.9","5.4"
"New Mexico","1986","383272","25598","6988","1.8","36.6","4741","16.1","3714","12.6","29909","2403","2406","13860","35717","41346","77063","20.1","9.3","46958","70075","23117","18.3","6.0"
"New York","1986","6499881","340644","188087","2.9","29.0","50293","13.2","41451","10.9","385808","28325","28407","162731","415196","714853","1130049","17.4","6.4","599361","941962","342601","14.5","5.3"
"North Carolina","1986","2300094","106573","113827","4.9","26.6","18767","14.7","12976","10.2","129909","8481","8573","53039","170998","248008","419006","18.2","7.4","196599","305179","108580","13.3","4.7"
"North Dakota","1986","189562","14663","-1049","-0.5","29.6","1876","11.1","1772","10.5","16882","1166","1169","5941","11605","16396","28001","14.8","6.1","19385","29050","9665","15.3","5.1"
"Ohio","1986","3727732","164812","95274","2.6","27.8","24868","12.2","19914","9.8","205807","12613","12651","108633","230213","384445","614658","16.5","6.2","326593","519384","192791","13.9","5.2"
"Oklahoma","1986","944842","57575","-17841","-1.9","34.4","9345","13.6","9841","14.3","68284","6903","6921","37329","73128","89397","162525","17.2","7.7","112021","180366","68345","19.1","7.2"
"Oregon","1986","844527","55462","24598","2.9","32.0","9833","15.4","7798","12.2","64798","5225","5230","30161","66569","93285","159854","18.9","7.9","81606","135256","53650","16.0","6.4"
"Pennsylvania","1986","4076649","189315","124558","3.0","27.8","29142","12.9","21221","9.4","228738","13423","13456","99275","276212","413120","689332","16.9","6.8","367870","564774","196904","13.9","4.8"
"Rhode Island","1986","369651","20131","20138","5.4","24.2","3067","14.0","2141","9.8","22348","1435","1439","10578","24409","40356","64765","17.5","6.6","27272","44627","17355","12.1","4.7"
"South Carolina","1986","1044552","52164","27904","2.6","31.0","9136","14.7","6574","10.6","63180","4250","4253","26641","75649","113852","189501","18.1","7.2","102460","161597","59137","15.5","5.7"
"South Dakota","1986","193007","14950","437","0.3","30.4","1937","11.5","1766","10.5","16954","1115","1116","6723","12482","17340","29822","15.5","6.5","18745","29385","10640","15.2","5.5"
"Tennessee","1986","1603062","75788","69376","4.4","28.6","13070","14.4","10013","11.1","91817","6690","6703","47135","115740","183370","299110","18.7","7.2","142084","229734","87650","14.3","5.5"
"Texas","1986","5561133","277741","2821","0.0","39.2","52914","15.3","46156","13.4","348259","31056","31199","211728","472714","618866","1091580","19.6","8.5","688319","1088759","400440","19.6","7.2"
"Utah","1986","481290","25259","13011","2.7","35.4","4564","15.3","3935","13.2","30150","2551","2560","17844","43612","54473","98085","20.4","9.1","53784","85074","31290","17.7","6.5"
"Vermont","1986","194338","13768","11508","5.9","24.6","2338","15.7","1623","10.9","15239","1120","1120","5725","13940","21445","35385","18.2","7.2","14524","23877","9353","12.3","4.8"
"Virginia","1986","1916697","93021","139143","7.2","26.0","17105","15.3","11114","10.0","114574","7062","7077","42478","158225","229204","387429","20.2","8.3","158845","248286","89441","13.0","4.7"
"Washington","1986","1380402","85622","60191","4.3","33.4","15705","15.8","12161","12.2","100918","7811","7853","47218","111590","178770","290360","21.0","8.1","140431","230169","89738","16.7","6.5"
"West Virginia","1986","446056","27209","4132","0.9","33.6","3996","12.5","3654","11.4","32207","2302","2308","12429","37048","42092","79140","17.7","8.3","41712","75008","33296","16.8","7.5"
"Wisconsin","1986","1599541","80616","6400","0.4","29.8","10425","10.8","12873","13.3","95092","6914","6949","42178","91476","153046","244522","15.3","5.7","129004","238122","109118","14.9","6.8"
"Wyoming","1986","133664","11366","-2998","-2.2","37.4","1668","12.7","1844","14.0","13021","1239","1240","6534","10978","13955","24933","18.7","8.2","17477","27931","10454","20.9","7.8"
"Alabama","1987","1200238","60258","15217","1.2","33.6","11313","15.6","8636","11.9","73813","5560","5603","33710","85721","130889","216610","18.0","7.1","129048","201393","72345","16.8","6.0"
"Alaska","1987","145006","9909","-10119","-7.0","40.0","2014","16.9","2281","19.2","11684","1453","1467","9133","12933","16079","29012","20.0","8.9","23028","39131","16103","27.0","11.1"
"Arizona","1987","1123696","58318","19749","1.7","40.2","13545","19.4","9662","13.8","71502","6185","6243","45399","115527","129757","245284","21.8","10.3","127604","225535","97931","20.1","8.7"
"Arkansas","1987","699345","39898","6755","1.0","32.4","6842","14.9","5660","12.3","46468","3946","3977","26184","46580","73758","120338","17.2","6.7","66988","113583","46595","16.2","6.7"
"California","1987","9883744","498637","282680","2.9","37.6","101130","17.1","74324","12.6","601790","47020","47572","364454","845682","1294653","2140335","21.7","8.6","1070030","1857655","787625","18.8","8.0"
"Colorado","1987","1179240","68775","-44189","-3.7","39.0","13875","17.0","12495","15.3","81912","7987","8086","57649","110481","119000","229481","19.5","9.4","154588","273670","119082","23.2","10.1"
"Connecticut","1987","1459992","68351","59084","4.1","26.6","11757","15.3","7985","10.4","78649","5283","5306","36699","92247","161076","253323","17.4","6.3","120289","194239","73950","13.3","5.1"
"Delaware","1987","272279","12152","-2998","-1.1","38.4","2247","16.3","1478","10.7","14145","928","930","5413","16706","35536","52242","19.2","6.1","40657","55240","14583","20.3","5.4"
"District of Columbia","1987","399585","14828","17221","4.3","26.2","2205","12.9","1898","11.1","17220","1065","1075","8846","24162","45559","69721","17.4","6.0","32095","52500","20405","13.1","5.1"
"Florida","1987","3985126","235617","135194","3.4","38.2","53022","19.0","37431","13.4","286073","25796","25981","175329","416100","480635","896735","22.5","10.4","441126","761541","320415","19.1","8.0"
"Geogia","1987","2265027","104235","66795","2.9","34.8","21394","16.8","15351","12.1","129764","9720","9794","67453","202803","257257","460060","20.3","9.0","240674","393265","152591","17.4","6.7"
"Hawaii","1987","353282","19499","16927","4.8","33.6","3522","15.0","2593","11.1","23814","1621","1632","11021","30077","46264","76341","21.6","8.5","34547","59414","24867","16.8","7.0"
"Idaho","1987","254619","18375","-1504","-0.6","37.4","3168","14.8","2637","12.3","21600","1535","1548","10497","20310","27258","47568","18.7","8.0","29061","49072","20011","19.3","7.9"
"Illinois","1987","4232605","192023","-6293","-0.2","32.4","30933","13.7","24886","11.0","228983","15370","15476","104806","265263","421816","687079","16.2","6.3","418615","693372","274757","16.4","6.5"
"Indiana","1987","1923141","88834","74524","3.9","29.0","14915","13.9","11508","10.7","108810","7325","7375","50562","127028","226917","353945","18.4","6.6","168453","279421","110968","14.5","5.8"
"Iowa","1987","879780","53491","12373","1.4","30.0","7803","12.1","7176","11.2","64363","4486","4539","24971","58643","85579","144222","16.4","6.7","80659","131849","51190","15.0","5.8"
"Kansas","1987","798343","48907","-25269","-3.2","34.0","7698","13.3","7132","12.3","57884","4639","4691","27901","59363","76428","135791","17.0","7.4","78021","161060","83039","20.2","10.4"
"Kentucky","1987","1101927","56376","22864","2.1","29.6","9376","14.1","7611","11.4","67318","4840","4853","30040","71549","114455","186004","16.9","6.5","95644","163140","67496","14.8","6.1"
"Louisiana","1987","1193986","66411","-67635","-5.6","34.4","10617","12.9","12637","15.4","80651","8110","8193","52757","90650","114132","204782","17.2","7.6","163589","272417","108828","22.8","9.1"
"Maine","1987","380019","24466","24437","6.4","27.0","4820","17.7","2921","10.7","28132","1912","1918","10720","31734","43915","75649","19.9","8.4","28680","51212","22532","13.5","5.9"
"Maryland","1987","1624802","75607","92607","5.7","31.6","14470","16.2","9703","10.8","91745","6105","6170","44401","159196","189855","349051","21.5","9.8","161990","256444","94454","15.8","5.8"
"Massachusetts","1987","2715234","116844","37830","1.4","32.2","19834","14.8","13913","10.3","137046","9122","9171","71481","176577","297398","473975","17.5","6.5","274836","436145","161309","16.1","5.9"
"Michigan","1987","3147301","142587","59168","1.9","30.2","24903","14.6","18161","10.6","173534","11694","11791","76827","204900","330709","535609","17.0","6.5","304442","476441","171999","15.1","5.5"
"Minnesota","1987","1652382","77712","28587","1.8","31.4","12695","13.8","10134","11.0","92833","6287","6335","62679","110229","178600","288829","17.5","6.7","147091","260242","113151","15.7","6.8"
"Mississippi","1987","692385","38752","-3018","-0.5","33.8","6560","14.3","5563","12.1","46339","3713","3746","23234","47639","69687","117326","16.9","6.9","77357","120344","42987","17.4","6.2"
"Missouri","1987","1870316","91762","43415","2.3","32.2","16482","15.1","12576","11.5","110633","8070","8145","54232","137609","206735","344344","18.4","7.4","181053","300929","119876","16.1","6.4"
"Montana","1987","217775","19005","2227","1.0","35.8","3186","14.7","2933","13.5","21722","1877","1893","8804","17277","23972","41249","18.9","7.9","23245","39022","15777","17.9","7.2"
"Nebraska","1987","527217","33068","9115","1.7","29.6","4629","12.1","3928","10.2","38628","2524","2552","14757","32348","54869","87217","16.5","6.1","44978","78102","33124","14.8","6.3"
"Nevada","1987","415841","19135","36110","8.7","32.0","4226","19.4","2976","13.7","22309","1873","1893","14675","41927","60590","102517","24.7","10.1","39602","66407","26805","16.0","6.4"
"New Hampshire","1987","444310","25249","18079","4.0","32.0","5401","19.7","3030","11.0","28557","2032","2037","14418","36549","52463","89012","20.0","8.2","43322","70933","27611","16.0","6.2"
"New Jersey","1987","3053041","155668","104006","3.4","33.8","26411","15.1","18969","10.9","178070","12492","12555","86591","253114","368032","621146","20.3","8.3","319027","517140","198113","16.9","6.5"
"New Mexico","1987","393305","25937","4348","1.2","38.8","4754","15.7","3987","13.2","30459","2608","2622","16473","36907","43929","80836","20.6","9.4","46870","76488","29618","19.4","7.5"
"New York","1987","6760940","346612","110962","1.7","30.6","54495","14.0","44355","11.4","394396","30975","31100","201760","396993","750947","1147940","17.0","5.9","654669","1036978","382309","15.3","5.7"
"North Carolina","1987","2388193","109913","36095","1.5","32.0","20694","15.6","14436","10.9","135644","9271","9304","61799","161377","257227","418604","17.5","6.8","241608","382509","140901","16.0","5.9"
"North Dakota","1987","190797","14755","2153","1.1","29.6","2119","12.5","1871","11.0","17058","1195","1204","6034","12851","17520","30371","15.9","6.7","17380","28218","10838","14.8","5.7"
"Ohio","1987","3834228","168401","75018","1.9","30.8","28393","13.6","21448","10.3","211958","13069","13196","94165","253154","411631","664785","17.3","6.6","350739","589767","239028","15.4","6.2"
"Oklahoma","1987","925714","55905","-42012","-4.6","33.2","9301","13.7","10158","15.0","66914","6722","6799","40496","72602","81332","153934","16.6","7.8","117918","195946","78028","21.2","8.4"
"Oregon","1987","876897","56822","31188","3.5","33.0","10977","16.7","8551","13.0","66905","5621","5650","34866","72283","103177","175460","20.0","8.2","82222","144272","62050","16.5","7.1"
"Pennsylvania","1987","4211900","194697","85433","2.1","29.6","31900","13.7","23240","10.0","236702","14650","14768","107955","268721","441770","710491","16.9","6.4","381901","625058","243157","14.8","5.8"
"Rhode Island","1987","388723","20985","14748","3.8","27.2","3504","15.3","2390","10.5","23374","1637","1650","10956","24483","43151","67634","17.4","6.3","32441","52886","20445","13.6","5.3"
"South Carolina","1987","1089692","53782","45237","4.2","30.4","10323","16.0","7369","11.4","65831","4649","4688","30471","83460","127843","211303","19.4","7.7","101304","166066","64762","15.2","5.9"
"South Dakota","1987","198232","15111","4027","2.1","28.2","2220","13.0","1938","11.3","17196","1202","1209","6409","13100","18938","32038","16.2","6.6","16703","28011","11308","14.1","5.7"
"Tennessee","1987","1672313","78066","42237","2.5","32.0","14691","15.7","10644","11.4","95419","7096","7129","49284","118339","191234","309573","18.5","7.1","156359","267336","110977","16.0","6.6"
"Texas","1987","5478753","273401","-231308","-4.2","37.0","53577","15.4","53079","15.3","346457","34454","34860","237080","466491","547355","1013846","18.5","8.5","741502","1245154","503652","22.7","9.2"
"Utah","1987","496982","25704","5775","1.2","36.8","5009","16.4","4136","13.5","30862","2522","2566","17771","38705","58526","97231","19.6","7.8","53781","91456","37675","18.4","7.6"
"Vermont","1987","207870","14606","12822","6.2","26.2","2656","16.9","1583","10.1","16245","1121","1134","6760","17618","22445","40063","19.3","8.5","15807","27241","11434","13.1","5.5"
"Virginia","1987","2036958","96918","93425","4.6","31.2","19610","16.6","12893","10.9","120928","8210","8285","53752","173310","238372","411682","20.2","8.5","191232","318257","127025","15.6","6.2"
"Washington","1987","1423705","88044","64861","4.5","33.8","17335","16.9","13066","12.7","104592","8351","8438","53066","125179","179982","305161","21.4","8.8","141492","240300","98808","16.9","6.9"
"West Virginia","1987","452255","27543","3274","0.8","31.8","4621","14.2","3678","11.3","32931","2402","2415","14349","32401","42953","75354","16.7","7.2","43916","72080","28164","15.9","6.2"
"Wisconsin","1987","1672542","86963","94914","5.7","22.8","14396","14.5","7186","7.3","103021","1857","1920","17586","120228","165742","285970","17.1","7.2","130780","191056","60276","11.4","3.6"
"Wyoming","1987","127412","11030","-11441","-9.0","30.6","1673","13.0","1930","15.0","12660","1188","1196","6212","8937","10553","19490","15.3","7.0","18637","30931","12294","24.3","9.6"
"Alabama","1988","1208299","60133","33205","2.8","31.2","9836","13.3","8891","12.1","74074","5836","5836","33259","93070","129015","222085","18.4","7.7","115247","188880","73633","15.6","6.1"
"Alaska","1988","133238","9722","-3369","-2.5","45.4","1814","15.7","1861","16.1","11502","1148","1148","6412","12815","17375","30190","22.7","9.6","18157","33559","15402","25.2","11.6"
"Arizona","1988","1141813","58831","50887","4.5","37.4","11908","16.5","10152","14.1","72792","6765","6765","44302","116438","148530","264968","23.2","10.2","126977","214081","87104","18.7","7.6"
"Arkansas","1988","676843","38802","17881","2.6","30.4","5764","12.6","5683","12.4","45640","3915","3915","19632","46066","74680","120746","17.8","6.8","61819","102865","41046","15.2","6.1"
"California","1988","10149718","505005","423957","4.2","35.6","89631","14.8","75767","12.5","612513","49544","49545","319211","822891","1405242","2228133","22.0","8.1","1117673","1804176","686503","17.8","6.8"
"Colorado","1988","1156028","67973","10118","0.9","37.4","12191","14.9","12132","14.9","81494","8319","8319","45630","92574","133862","226436","19.6","8.0","123436","216318","92882","18.7","8.0"
"Connecticut","1988","1482419","70038","23843","1.6","32.2","11063","13.9","8430","10.6","80886","5704","5704","38946","106749","155394","262143","17.7","7.2","142399","238300","95901","16.1","6.5"
"Delaware","1988","278434","12312","15707","5.7","28.4","1965","13.8","1660","11.6","14401","982","982","6084","20849","34482","55331","19.9","7.5","23717","39624","15907","14.2","5.7"
"District of Columbia","1988","412673","14784","218","0.1","33.8","2131","12.3","1887","10.9","17420","1124","1124","10419","22092","48057","70149","17.0","5.4","49203","69931","20728","16.9","5.0"
"Florida","1988","4128970","240864","188680","4.5","35.4","48708","16.8","39613","13.7","294111","28179","28181","165880","388618","530071","918689","22.2","9.4","424069","730009","305940","17.7","7.4"
"Geogia","1988","2334375","105905","112735","4.8","32.4","19487","14.9","15821","12.1","132685","10461","10464","65213","203681","286812","490493","21.0","8.7","229807","377758","147951","16.2","6.3"
"Hawaii","1988","372821","19794","18165","4.9","28.4","3087","12.8","2558","10.6","24301","1688","1688","8967","25953","45175","71128","19.1","7.0","32299","52963","20664","14.2","5.5"
"Idaho","1988","254539","18123","10923","4.3","32.2","2746","12.8","2564","12.0","21455","1725","1725","9259","21446","30491","51937","20.4","8.4","24162","41014","16852","16.1","6.6"
"Illinois","1988","4241579","192616","187305","4.4","27.4","28147","12.3","23732","10.3","231231","15499","15499","95916","280592","487064","767656","18.1","6.6","362037","580351","218314","13.7","5.1"
"Indiana","1988","1950551","89111","57225","2.9","28.4","12975","11.9","11344","10.4","109639","7420","7420","62030","122440","211912","334352","17.1","6.3","162839","277127","114288","14.2","5.9"
"Iowa","1988","893896","52712","51526","5.8","24.0","6597","10.3","6565","10.3","63826","4300","4301","20523","52194","106545","158739","17.8","5.8","63071","107213","44142","12.0","4.9"
"Kansas","1988","787135","48576","22551","2.9","29.8","6994","12.1","6377","11.0","58039","4328","4328","24363","58012","82026","140038","17.8","7.4","71163","117487","46324","14.9","5.9"
"Kentucky","1988","1070294","56081","46502","4.4","28.4","8637","12.9","7582","11.3","67582","5323","5323","30685","77680","120944","198624","18.6","7.3","92132","152122","59990","14.2","5.6"
"Louisiana","1988","1157912","64474","22211","1.9","34.4","9615","12.1","10602","13.3","79045","7153","7153","40798","84223","136862","221085","19.1","7.3","117066","198874","81808","17.2","7.1"
"Maine","1988","399702","25145","26668","6.7","26.6","4249","14.9","3185","11.2","28904","2191","2191","10580","26867","52902","79769","20.0","6.7","33769","53101","19332","13.3","4.8"
"Maryland","1988","1697971","77607","61334","3.6","33.6","13530","14.5","10254","11.0","94737","6595","6595","47169","135241","211042","346283","20.4","8.0","187777","284949","97172","16.8","5.7"
"Massachusetts","1988","2774318","119327","73092","2.6","30.6","17905","12.9","14404","10.4","140083","9538","9538","73354","177471","319298","496769","17.9","6.4","270757","423677","152920","15.3","5.5"
"Michigan","1988","3185315","143989","48321","1.6","30.6","21535","12.3","18880","10.8","175707","12055","12055","70380","208433","328796","537229","16.9","6.5","317037","488908","171871","15.3","5.4"
"Minnesota","1988","1678821","77716","63760","3.8","29.2","11332","12.2","10005","10.8","93508","6375","6375","43109","105018","203385","308403","18.4","6.3","152028","244643","92615","14.6","5.5"
"Mississippi","1988","670222","38013","22669","3.4","28.6","5580","12.1","5642","12.3","45843","3896","3897","19049","47411","71422","118833","17.7","7.1","58733","96164","37431","14.3","5.6"
"Missouri","1988","1854926","91198","13597","0.7","33.6","14218","12.9","12813","11.6","110815","8419","8419","46165","124591","200290","324881","17.5","6.7","175153","311284","136131","16.8","7.3"
"Montana","1988","198085","18279","-1877","-1.0","36.6","2677","12.6","2868","13.5","21065","1863","1863","8789","14647","21620","36267","18.3","7.4","21580","38144","16564","19.3","8.4"
"Nebraska","1988","522236","32283","25779","4.9","26.8","4190","11.0","3867","10.2","38082","2535","2535","12417","35151","60676","95827","18.3","6.7","41112","70048","28936","13.4","5.5"
"Nevada","1988","445287","19608","27413","6.2","36.8","3865","17.0","3002","13.2","23086","2012","2012","14137","41415","67933","109348","24.6","9.3","46294","81935","35641","18.4","8.0"
"New Hampshire","1988","439825","25833","20225","4.6","31.6","4657","16.2","3531","12.2","29339","2503","2503","13495","37679","52062","89741","20.4","8.6","44178","69516","25338","15.8","5.8"
"New Jersey","1988","3112640","158581","85381","2.7","32.4","24536","13.6","19500","10.8","182189","13325","13325","70783","215975","373149","589124","18.9","6.9","337311","503743","166432","16.2","5.3"
"New Mexico","1988","382932","25540","5675","1.5","36.8","4192","13.8","4075","13.4","30306","2750","2750","15907","29824","46266","76090","19.9","7.8","42095","70415","28320","18.4","7.4"
"New York","1988","6811429","348575","105600","1.6","32.0","50752","12.8","45035","11.4","398492","31748","31749","171335","400716","797883","1198599","17.6","5.9","724497","1092999","368502","16.0","5.4"
"North Carolina","1988","2443107","111672","123336","5.1","27.0","18924","13.8","15115","11.0","138754","9816","9816","50902","177742","275522","453264","18.6","7.3","206190","329928","123738","13.5","5.1"
"North Dakota","1988","180615","14344","5528","3.1","27.6","1784","10.7","1802","10.8","16650","1141","1141","5221","11435","19060","30495","16.9","6.3","14552","24967","10415","13.8","5.8"
"Ohio","1988","3939083","170138","141355","3.6","27.8","25144","11.8","22123","10.4","214686","13474","13475","76221","258245","430917","689162","17.5","6.6","353534","547807","194273","13.9","4.9"
"Oklahoma","1988","867352","53602","17273","2.0","34.4","8135","12.4","9274","14.1","64831","6193","6193","31929","65195","101533","166728","19.2","7.5","85690","149455","63765","17.2","7.4"
"Oregon","1988","887575","56728","45796","5.2","31.4","9538","14.3","8447","12.6","67301","5723","5723","29244","68200","117373","185573","20.9","7.7","81133","139777","58644","15.7","6.6"
"Pennsylvania","1988","4298059","197264","117801","2.7","28.6","28607","12.0","23971","10.1","240412","15464","15467","106051","262643","468062","730705","17.0","6.1","380802","612904","232102","14.3","5.4"
"Rhode Island","1988","397924","21357","6803","1.7","30.8","3173","13.5","2663","11.3","23771","1766","1766","9857","23170","45026","68196","17.1","5.8","37837","61393","23556","15.4","5.9"
"South Carolina","1988","1121053","54527","73399","6.5","27.8","9438","14.2","7770","11.7","67141","5129","5129","27206","102549","126500","229049","20.4","9.1","94565","155650","61085","13.9","5.4"
"South Dakota","1988","190724","14953","7037","3.7","27.0","1976","11.6","1862","10.9","17063","1202","1202","5517","12910","19808","32718","17.2","6.8","14881","25681","10800","13.5","5.7"
"Tennessee","1988","1702024","78439","79963","4.7","31.2","13377","14.0","11071","11.5","96811","7400","7400","43981","152148","193921","346069","20.3","8.9","158589","266106","107517","15.6","6.3"
"Texas","1988","5365881","266880","78429","1.5","38.2","47230","13.7","50099","14.6","341407","33950","33950","198917","457121","646101","1103222","20.6","8.5","599496","1024793","425297","19.1","7.9"
"Utah","1988","492490","25513","14177","2.8","35.2","4516","14.6","4247","13.8","30856","2835","2835","18732","42591","58048","100639","20.4","8.6","49720","86462","36742","17.6","7.5"
"Vermont","1988","204173","14785","3345","1.7","31.6","2368","14.6","1817","11.2","16484","1281","1281","6930","14333","21302","35635","17.5","7.0","19514","32290","12776","15.8","6.3"
"Virginia","1988","2105658","99471","107274","5.1","29.6","17904","14.6","13531","11.0","124670","8730","8730","47580","169562","249631","419193","19.9","8.1","192681","311919","119238","14.8","5.7"
"Washington","1988","1461310","88773","79207","5.4","33.4","15493","14.7","13088","12.5","105987","8497","8499","46219","113996","209298","323294","22.1","7.8","146393","244087","97694","16.7","6.7"
"West Virginia","1988","447788","27511","9172","2.1","30.4","3924","12.0","3615","11.0","32973","2395","2395","12605","30540","46795","77335","17.3","6.8","42530","68163","25633","15.2","5.7"
"Wisconsin","1988","1755600","87621","81240","4.6","24.4","11564","11.2","9948","9.6","104247","6663","6663","38149","104054","190523","294577","16.8","5.9","137490","213337","75847","12.2","4.3"
"Wyoming","1988","119605","10765","-290","-0.3","36.8","1480","11.8","1645","13.2","12384","1060","1060","4752","8670","13368","22038","18.4","7.2","13048","22328","9280","18.7","7.8"
"Alabama","1989","1259370","61306","59688","4.7","27.6","10009","13.3","8158","10.9","76014","5660","5685","34928","91168","141841","233009","18.5","7.2","112241","173321","61080","13.8","4.9"
"Alaska","1989","134618","8518","5314","4.0","45.4","1495","13.7","2619","23.9","10384","884","887","4217","16160","19749","35909","26.7","12.0","12849","30595","17746","22.7","13.2"
"Arizona","1989","1187751","59371","36770","3.1","37.0","11479","15.7","10299","14.0","73858","6826","6862","52184","108617","147788","256405","21.6","9.1","130100","219635","89535","18.5","7.5"
"Arkansas","1989","702968","39202","31129","4.5","27.6","5746","12.5","5050","11.0","46467","3561","3622","25409","53331","75051","128382","18.3","7.6","57861","97253","39392","13.8","5.6"
"California","1989","10516224","497327","313698","3.0","36.2","87685","14.3","90078","14.7","610180","48921","49255","371483","823088","1391488","2214576","21.1","7.8","1094656","1900878","806222","18.1","7.7"
"Colorado","1989","1182445","67995","37366","3.1","33.6","11280","13.8","11054","13.6","81688","7366","7398","48658","94535","141137","235672","19.9","8.0","110635","198306","87671","16.8","7.4"
"Connecticut","1989","1500115","70819","23511","1.6","29.8","10080","12.4","8952","11.0","82079","6102","6146","39044","89312","157690","247002","16.5","6.0","144475","223491","79016","14.9","5.3"
"Delaware","1989","295576","12979","17880","6.0","27.2","2278","15.4","1468","9.9","15238","935","939","6322","25642","32434","58076","19.6","8.7","29233","40196","10963","13.6","3.7"
"District of Columbia","1989","405978","14740","8855","2.2","29.4","2055","11.7","1844","10.5","17671","1097","1099","10076","21286","47129","68415","16.9","5.2","37985","59560","21575","14.7","5.3"
"Florida","1989","4340752","246158","200865","4.6","34.0","46039","15.5","38421","12.9","301917","26774","26943","173642","381828","555365","937193","21.6","8.8","443595","736328","292733","17.0","6.7"
"Geogia","1989","2432773","107578","64537","2.6","35.2","18807","14.0","15789","11.8","135772","10394","10446","77006","204011","287623","491634","20.2","8.4","278996","427097","148101","17.6","6.1"
"Hawaii","1989","393082","20055","22037","5.6","25.8","2970","12.1","2428","9.9","24868","1614","1614","10181","28842","43726","72568","18.5","7.3","31121","50531","19410","12.9","4.9"
"Idaho","1989","271892","18394","22038","8.1","27.2","2836","13.1","2469","11.4","21842","1574","1596","9385","23715","35329","59044","21.7","8.7","21345","37006","15661","13.6","5.8"
"Illinois","1989","4413452","195191","147705","3.4","27.4","27828","11.9","23572","10.1","235604","15220","15424","109927","291149","462224","753373","17.1","6.6","396453","605668","209215","13.7","4.7"
"Indiana","1989","2037085","90618","98253","4.9","24.4","13116","11.8","10645","9.6","112236","7194","7242","53326","123044","224480","347524","17.1","6.0","155674","249271","93597","12.2","4.6"
"Iowa","1989","947453","53217","58109","6.2","23.0","6643","10.3","5850","9.1","64661","3994","3999","22412","67668","99762","167430","17.7","7.1","66570","109321","42751","11.5","4.5"
"Kansas","1989","824926","48577","52066","6.3","27.6","6609","11.4","6329","10.9","58350","4383","4407","26349","80481","85671","166152","20.1","9.8","69930","114086","44156","13.8","5.4"
"Kentucky","1989","1115697","56900","45433","4.0","27.2","8303","12.2","7008","10.3","68895","4895","4920","31698","74254","122472","196726","17.6","6.7","93017","151293","58276","13.6","5.2"
"Louisiana","1989","1186687","63629","32851","2.8","32.2","8641","11.0","9323","11.8","78520","6186","6229","42411","82528","141364","223892","18.9","7.0","116729","191041","74312","16.1","6.3"
"Maine","1989","420289","25805","13799","3.3","30.0","4177","14.2","3279","11.2","29875","2274","2308","14345","28191","48851","77042","18.3","6.7","39654","63243","23589","15.0","5.6"
"Maryland","1989","1749401","79783","37407","2.1","32.0","13061","13.6","9983","10.4","97856","6471","6498","46466","124332","192933","317265","18.1","7.1","186732","279858","93126","16.0","5.3"
"Massachusetts","1989","2836688","120312","44103","1.5","30.8","16701","11.8","14844","10.5","142397","10198","10370","76971","169011","311186","480197","16.9","6.0","295245","436094","140849","15.4","5.0"
"Michigan","1989","3272939","146920","119576","3.7","26.6","21646","12.2","17318","9.7","180311","11608","11675","80289","191563","363703","555266","17.0","5.9","291221","435690","144469","13.3","4.4"
"Minnesota","1989","1740605","79180","59625","3.4","26.8","11414","12.1","9196","9.7","95704","5974","6011","43493","108311","183985","292296","16.8","6.2","139752","232671","92919","13.4","5.3"
"Mississippi","1989","695980","38176","17864","2.6","28.8","5583","12.1","5062","11.0","46432","3514","3546","22423","45903","72162","118065","17.0","6.6","60361","100201","39840","14.4","5.7"
"Missouri","1989","1900552","92882","73274","3.8","28.2","14291","12.8","11751","10.5","113353","7935","7996","53542","120108","220378","340486","17.9","6.3","171597","267212","95615","14.1","5.0"
"Montana","1989","202220","18447","10446","5.1","29.2","2701","12.8","2460","11.6","21256","1639","1641","7672","16129","23741","39870","19.7","8.0","17521","29424","11903","14.6","5.9"
"Nebraska","1989","546735","32512","23120","4.2","25.8","4293","11.2","3776","9.9","38574","2525","2535","15480","34249","59152","93401","17.1","6.3","42793","70281","27488","12.9","5.0"
"Nevada","1989","478236","20656","36750","7.7","33.2","4142","17.5","2856","12.0","24365","1860","1868","17097","40897","75467","116364","24.3","8.6","46080","79614","33534","16.6","7.0"
"New Hampshire","1989","455591","25964","7763","1.7","31.4","4078","13.8","3707","12.6","29721","2715","2741","17045","34409","44936","79345","17.4","7.6","45370","71582","26212","15.7","5.8"
"New Jersey","1989","3186478","159955","47611","1.5","32.8","22984","12.5","20522","11.2","184810","13692","13748","89068","209294","362351","571645","17.9","6.6","353786","524034","170248","16.4","5.3"
"New Mexico","1989","389990","25766","8256","2.1","34.4","4225","13.9","3853","12.6","30708","2568","2586","15550","30448","44998","75446","19.3","7.8","41715","67190","25475","17.2","6.5"
"New York","1989","6922355","351755","124888","1.8","29.6","50602","12.6","45366","11.3","404333","31578","31762","195782","411152","738375","1149527","16.6","5.9","673236","1024639","351403","14.8","5.1"
"North Carolina","1989","2557204","114402","72047","2.8","28.6","18299","13.0","14564","10.4","142586","9466","9524","58887","169917","266740","436657","17.1","6.6","244833","364610","119777","14.3","4.7"
"North Dakota","1989","184980","14374","4761","2.6","26.2","1673","10.0","1554","9.3","16777","1069","1072","5263","11733","17256","28989","15.7","6.3","14872","24228","9356","13.1","5.1"
"Ohio","1989","4096283","172489","140412","3.4","27.4","24718","11.4","20521","9.5","219033","13319","13439","92377","266428","433185","699613","17.1","6.5","352719","559201","206482","13.7","5.0"
"Oklahoma","1989","891090","53837","25885","2.9","31.2","8224","12.6","7926","12.2","65207","5432","5468","34900","62305","102391","164696","18.5","7.0","80076","138811","58735","15.6","6.6"
"Oregon","1989","919420","51213","13016","1.4","40.8","8202","12.7","13447","20.8","62002","5143","5178","31825","67689","132905","200594","21.8","7.4","75352","187578","112226","20.4","12.2"
"Pennsylvania","1989","4409414","201138","127404","2.9","26.6","28179","11.6","22807","9.4","245949","14985","15157","105869","260079","453036","713115","16.2","5.9","372676","585711","213035","13.3","4.8"
"Rhode Island","1989","404615","21791","2779","0.7","31.6","3142","13.1","2637","11.0","24360","1892","1919","14484","28036","38662","66698","16.5","6.9","41264","63919","22655","15.8","5.6"
"South Carolina","1989","1182060","55592","39269","3.3","28.8","8894","13.1","7258","10.7","68817","4855","4872","36461","81280","128057","209337","17.7","6.9","102900","170068","67168","14.4","5.7"
"South Dakota","1989","198652","15131","8732","4.4","25.6","1898","11.0","1587","9.2","17346","1116","1116","5681","11312","22767","34079","17.2","5.7","15602","25347","9745","12.8","4.9"
"Tennessee","1989","1789321","79653","75534","4.3","29.2","12914","13.2","10607","10.8","99307","7197","7341","56822","128938","208621","337559","18.9","7.2","164726","262025","97299","14.6","5.4"
"Texas","1989","5508593","265421","176156","3.2","35.0","44527","13.1","45313","13.3","340887","29642","30014","226498","438091","701821","1139912","20.7","8.0","554776","963756","408980","17.5","7.4"
"Utah","1989","520388","25495","33647","6.5","31.8","4173","13.5","3979","12.9","31047","2576","2658","19902","46586","70045","116631","22.4","9.0","48807","82984","34177","15.9","6.6"
"Vermont","1989","212300","15271","10646","5.0","24.8","2444","14.6","1861","11.1","17094","1365","1390","7117","14816","22146","36962","17.4","7.0","15765","26316","10551","12.4","5.0"
"Virginia","1989","2211800","101909","91892","4.2","28.6","17512","13.8","13557","10.7","128755","8821","8901","56501","165216","243625","408841","18.5","7.5","206672","316949","110277","14.3","5.0"
"Washington","1989","1530599","75543","54366","3.5","43.4","12963","13.0","25690","25.8","93124","8112","8170","54996","113917","272000","385917","25.2","7.4","129122","331551","202429","21.7","13.2"
"West Virginia","1989","461621","27714","13203","2.9","27.8","3795","11.4","3398","10.2","33385","2318","2330","13893","33362","44048","77410","16.8","7.2","40784","64207","23423","13.9","5.1"
"Wisconsin","1989","1834614","88782","72015","4.0","24.4","11772","11.2","9823","9.3","106209","6536","6573","44682","94640","201779","296419","16.2","5.2","141592","224404","82812","12.2","4.5"
"Wyoming","1989","121576","10698","4088","3.4","31.2","1423","11.5","1428","11.5","12358","932","937","4581","8405","14697","23102","19.0","6.9","11818","19014","7196","15.6","5.9"
"Alabama","1990","1308045","62128","43390","3.3","26.6","9446","12.3","7845","10.2","77158","5512","5556","35188","72790","144530","217320","16.6","5.6","114913","173930","59017","13.3","4.5"
"Alaska","1990","143520","10157","20628","14.4","31.4","2828","25.2","1072","9.5","12097","648","649","4045","22297","20866","43163","30.1","15.5","15247","22535","7288","15.7","5.1"
"Arizona","1990","1211932","60339","19636","1.6","36.0","11266","15.1","9402","12.6","75080","6365","6416","43173","94689","143199","237888","19.6","7.8","139118","218252","79134","18.0","6.5"
"Arkansas","1990","730873","39886","26607","3.6","25.4","5776","12.3","4608","9.8","47312","3319","3321","17988","41301","77869","119170","16.3","5.7","63456","92563","29107","12.7","4.0"
"California","1990","10908220","526427","519725","4.8","32.4","104509","16.7","67345","10.8","642827","45313","45517","342700","920105","1365773","2285878","21.0","8.4","1146406","1766153","619747","16.2","5.7"
"Colorado","1990","1220282","69416","38991","3.2","31.2","11760","14.2","9552","11.6","83404","6444","6478","45973","93101","135958","229059","18.8","7.6","110159","190068","79909","15.6","6.5"
"Connecticut","1990","1497164","70300","-21620","-1.4","27.0","9025","11.0","8638","10.5","81871","5973","6003","37713","74476","127649","202125","13.5","5.0","154075","223745","69670","14.9","4.7"
"Delaware","1990","308937","13461","9107","3.0","24.2","2148","13.8","1445","9.3","15859","958","958","5745","14302","32238","46540","15.1","4.6","27348","37433","10085","12.1","3.3"
"District of Columbia","1990","408738","14497","-4353","-1.1","27.8","1880","10.7","1970","11.2","17468","1237","1241","7679","18056","38782","56838","13.9","4.4","43669","61191","17522","15.0","4.3"
"Florida","1990","4485056","251806","125533","2.8","33.8","46520","15.2","36577","12.0","309518","26337","26475","171200","361686","521385","883071","19.7","8.1","472645","757538","284893","16.9","6.4"
"Geogia","1990","2487945","108444","49840","2.0","31.6","17768","13.0","15063","11.0","137562","10128","10188","69692","161299","282379","443678","17.8","6.5","255758","393838","138080","15.8","5.5"
"Hawaii","1990","414778","20775","23204","5.6","24.4","3227","12.8","2199","8.7","25751","1418","1421","11112","27805","45969","73774","17.8","6.7","32101","50570","18469","12.2","4.5"
"Idaho","1990","288998","19489","13554","4.7","28.4","3311","14.8","1991","8.9","23039","1388","1395","8422","18554","35973","54527","18.9","6.4","27442","40973","13531","14.2","4.7"
"Illinois","1990","4534140","198556","105397","2.3","25.8","27028","11.4","21638","9.1","239858","14411","14472","98184","243317","446787","690104","15.2","5.4","397922","584707","186785","12.9","4.1"
"Indiana","1990","2106302","92188","49759","2.4","25.0","12940","11.4","10020","8.8","114595","6922","6951","44788","108421","204817","313238","14.9","5.1","181403","263479","82076","12.5","3.9"
"Iowa","1990","991671","53791","30712","3.1","22.6","6476","9.9","5322","8.2","65557","3704","3717","21913","46380","96150","142530","14.4","4.7","77059","111818","34759","11.3","3.5"
"Kansas","1990","864234","48532","28865","3.4","25.6","6412","11.0","6004","10.3","58428","4142","4156","23465","50104","89735","139839","16.2","5.8","69576","110974","41398","12.8","4.8"
"Kentucky","1990","1155358","57929","41889","3.6","26.2","8451","12.1","6669","9.6","70283","4701","4715","30148","70528","122828","193356","16.7","6.1","99129","151467","52338","13.1","4.5"
"Louisiana","1990","1224466","63913","50933","4.1","28.8","8939","11.4","8093","10.3","78977","5509","5561","38258","80088","146993","227081","18.5","6.5","107675","176148","68473","14.4","5.6"
"Maine","1990","420075","25462","-11016","-2.6","28.0","3438","11.6","3415","11.5","29606","2405","2410","13710","23721","35170","58891","14.0","5.6","48182","69907","21725","16.6","5.2"
"Maryland","1990","1786035","81789","40937","2.3","30.2","12822","12.9","9704","9.8","100504","6285","6319","47001","112712","197522","310234","17.4","6.3","179418","269297","89879","15.1","5.0"
"Massachusetts","1990","2801266","117524","-112597","-4.1","25.6","14558","10.3","15630","11.1","140130","10847","10908","80959","129901","229965","359866","12.8","4.6","327396","472463","145067","16.9","5.2"
"Michigan","1990","3352229","149076","43012","1.2","27.8","20782","11.4","16673","9.2","183471","11303","11365","73224","183946","323881","507827","15.1","5.5","324201","464815","140614","13.9","4.2"
"Minnesota","1990","1795142","80981","56009","3.1","25.6","11162","11.5","8687","9.0","97753","5609","5644","39262","91717","193600","285317","15.9","5.1","148884","229308","80424","12.8","4.5"
"Mississippi","1990","714218","38524","21745","3.1","26.4","5585","12.0","4830","10.4","46867","3406","3428","19871","39857","76267","116124","16.3","5.6","60418","94379","33961","13.2","4.8"
"Missouri","1990","1952712","94420","35673","1.8","27.6","13611","11.9","11140","9.8","115207","7453","7486","45704","111852","192917","304769","15.6","5.7","183973","269096","85123","13.8","4.4"
"Montana","1990","213359","18796","9896","4.7","26.4","2583","12.0","2072","9.7","21649","1382","1383","6907","13084","25080","38164","17.9","6.1","17217","28268","11051","13.2","5.2"
"Nebraska","1990","568260","32829","21021","3.7","22.6","4048","10.4","3409","8.8","39007","2272","2273","12667","29321","55999","85320","15.0","5.2","42812","64299","21487","11.3","3.8"
"Nevada","1990","516403","21800","41073","7.9","29.2","4281","17.1","2740","10.9","25719","1913","1922","15904","36633","79598","116231","22.5","7.1","49244","75158","25914","14.6","5.0"
"New Hampshire","1990","455024","25125","-20950","-4.7","27.0","3521","12.0","3955","13.5","28975","2886","2888","17445","24597","37046","61643","13.5","5.4","54626","82593","27967","18.2","6.1"
"New Jersey","1990","3202458","159964","-9094","-0.2","31.4","21494","11.6","19302","10.4","185608","13363","13396","82249","187321","314179","501500","15.7","5.8","347395","510594","163199","15.9","5.1"
"New Mexico","1990","401338","26246","17344","4.3","29.6","4138","13.4","3404","11.0","31208","2243","2255","13287","28895","47798","76693","19.1","7.2","36237","59349","23112","14.8","5.8"
"New York","1990","6982030","351934","17203","0.3","29.6","46931","11.6","42872","10.6","405944","31041","31176","187280","359067","693090","1052157","15.1","5.1","702303","1034954","332651","14.8","4.8"
"North Carolina","1990","2628527","116947","78524","3.0","27.0","18136","12.6","13775","9.5","145997","9366","9413","68490","152507","280179","432686","16.5","5.8","228828","354162","125334","13.5","4.8"
"North Dakota","1990","190600","14394","6443","3.4","22.4","1609","9.6","1461","8.7","16812","1044","1045","4778","8513","19249","27762","14.6","4.5","13442","21319","7877","11.2","4.1"
"Ohio","1990","4198647","174524","65534","1.6","25.8","23686","10.7","19488","8.8","222305","12957","13041","95646","216348","392336","608684","14.5","5.2","372633","543150","170517","12.9","4.1"
"Oklahoma","1990","921164","54368","35606","3.9","27.0","7968","12.2","7012","10.7","65781","4819","4831","27956","57372","102640","160012","17.4","6.2","76718","124406","47688","13.5","5.2"
"Oregon","1990","962890","59146","78109","8.1","31.4","14931","22.6","6194","9.4","70345","4128","4159","27839","121443","107789","229232","23.8","12.6","100720","151123","50403","15.7","5.2"
"Pennsylvania","1990","4516192","204164","78589","1.8","25.4","26902","10.8","21437","8.6","250224","14589","14647","97080","210718","442405","653123","14.5","4.7","396193","574534","178341","12.7","3.9"
"Rhode Island","1990","398502","21626","-12465","-3.2","25.8","2690","11.1","2604","10.7","24238","1882","1883","10863","19017","32534","51551","12.9","4.8","44541","64016","19475","16.1","4.9"
"South Carolina","1990","1223846","56645","45566","3.7","26.2","8805","12.7","6911","9.9","70208","4751","4770","30049","74075","131281","205356","16.8","6.1","105059","159790","54731","13.1","4.5"
"South Dakota","1990","206824","15488","10710","5.2","24.6","2088","11.9","1542","8.8","17756","1080","1081","5457","13611","22576","36187","17.5","6.6","15394","25477","10083","12.3","4.9"
"Tennessee","1990","1844231","80435","35005","1.9","28.2","12319","12.3","10252","10.3","100697","7047","7063","45448","107860","187307","295167","16.0","5.8","172805","260162","87357","14.1","4.7"
"Texas","1990","5693271","269514","213427","3.7","32.2","46282","13.5","38757","11.3","346290","25945","26209","186064","423327","705177","1128504","19.8","7.4","546882","915077","368195","16.1","6.5"
"Utah","1990","550160","26102","28522","5.2","28.2","4189","13.3","3226","10.3","31757","2159","2171","16072","36557","69539","106096","19.3","6.6","48247","77574","29327","14.1","5.3"
"Vermont","1990","215990","15309","-1086","-0.5","29.2","2009","11.7","1789","10.4","17187","1326","1328","6384","11434","20141","31575","14.6","5.3","21660","32661","11001","15.1","5.1"
"Virginia","1990","2283216","104373","55489","2.5","28.8","17340","13.3","12922","9.9","132428","8585","8640","53343","143467","241439","384906","16.9","6.3","222875","329417","106542","14.4","4.7"
"Washington","1990","1633703","94750","152659","9.3","36.0","29651","28.7","8909","8.6","113374","5722","5746","76956","239874","206274","446148","27.3","14.7","165224","293489","128265","18.0","7.9"
"West Virginia","1990","474967","27960","14688","3.1","26.0","3837","11.4","3177","9.5","33771","2257","2262","13957","27703","48927","76630","16.1","5.8","39262","61942","22680","13.0","4.8"
"Wisconsin","1990","1897836","90232","56866","3.0","22.8","11456","10.7","8970","8.4","108203","6099","6129","38512","94143","179205","273348","14.4","5.0","145271","216482","71211","11.4","3.8"
"Wyoming","1990","126413","10838","5893","4.7","28.6","1461","11.8","1252","10.1","12498","823","824","3949","7995","16026","24021","19.0","6.3","10583","18128","7545","14.3","6.0"
"Alabama","1991","1330914","62962","5017","0.4","31.4","9724","12.5","8231","10.6","78721","5175","5238","36661","89491","124326","213817","16.1","6.7","135468","208800","73332","15.7","5.5"
"Alaska","1991","156297","10628","7345","4.7","34.4","1933","15.6","1257","10.1","12744","724","726","4227","12900","21366","34266","21.9","8.3","18824","26921","8097","17.2","5.2"
"Arizona","1991","1234743","62102","26248","2.1","37.0","11762","15.4","9233","12.1","77582","5808","5868","45391","109364","145021","254385","20.6","8.9","147452","228137","80685","18.5","6.5"
"Arkansas","1991","753032","40619","18599","2.5","28.2","6132","12.8","4905","10.2","48560","3244","3267","20026","53785","71253","125038","16.6","7.1","71535","106439","34904","14.1","4.6"
"California","1991","11037302","535853","-248131","-2.3","35.4","92230","14.2","75868","11.7","659054","47126","47649","387619","788570","1167586","1956156","17.7","7.1","1488560","2204287","715727","20.0","6.5"
"Colorado","1991","1255925","72125","32976","2.6","32.2","12798","15.0","9342","11.0","86888","5973","6061","41531","99290","136098","235388","18.7","7.9","126698","202412","75714","16.1","6.0"
"Connecticut","1991","1464471","68844","-43916","-3.0","28.0","8486","10.4","9420","11.6","80861","6023","6078","38537","85906","118937","204843","14.0","5.9","172321","248759","76438","17.0","5.2"
"Delaware","1991","312289","13870","-1355","-0.4","31.4","2302","14.2","1625","10.0","16554","970","984","5941","22864","26098","48962","15.7","7.3","33695","50317","16622","16.1","5.3"
"District of Columbia","1991","396999","14623","-18496","-4.7","26.0","1987","11.3","1914","10.9","17558","966","983","8076","20022","31566","51588","13.0","5.0","51801","70084","18283","17.7","4.6"
"Florida","1991","4537628","257912","-25136","-0.6","38.2","48435","15.4","39708","12.7","318238","25550","25897","179638","392545","474120","866665","19.1","8.7","574694","891801","317107","19.7","7.0"
"Geogia","1991","2479409","110728","-60939","-2.5","33.6","19158","13.8","15727","11.3","141028","9452","9665","92591","184111","232904","417015","16.8","7.4","304334","477954","173620","19.3","7.0"
"Hawaii","1991","432427","21514","8874","2.0","30.8","3547","13.5","2368","9.0","26947","1493","1510","10270","33266","42101","75367","17.4","7.7","47117","66493","19376","15.4","4.5"
"Idaho","1991","300810","20210","11025","3.7","30.8","3232","13.8","2238","9.5","23992","1384","1393","8255","22403","34952","57355","19.1","7.4","31037","46330","15293","15.4","5.1"
"Illinois","1991","4577187","201406","-10352","-0.2","29.4","28231","11.6","23286","9.6","244919","14479","14640","109221","272756","399344","672100","14.7","6.0","471093","682452","211359","14.9","4.6"
"Indiana","1991","2118027","93769","-20422","-0.9","28.2","13543","11.7","10656","9.2","117452","6926","7008","52981","121954","175748","297702","14.1","5.8","223128","318124","94996","15.0","4.5"
"Iowa","1991","1017620","54774","20555","2.0","24.8","6972","10.5","5312","8.0","67237","3419","3455","20816","50102","96704","146806","14.4","4.9","88726","126251","37525","12.4","3.7"
"Kansas","1991","879003","48877","2281","0.2","30.8","7012","11.9","6116","10.4","59283","3863","3915","25690","60093","77199","137292","15.6","6.8","88997","135011","46014","15.4","5.2"
"Kentucky","1991","1179232","58665","6692","0.6","30.8","8739","12.3","6979","9.8","72020","4683","4719","35264","80167","108606","188773","16.0","6.8","122521","182081","59560","15.4","5.1"
"Louisiana","1991","1262182","65002","24168","1.9","32.4","9684","12.1","7905","9.9","80890","5069","5117","39181","86306","142599","228905","18.1","6.8","129459","204737","75278","16.2","6.0"
"Maine","1991","404958","25173","-18033","-4.5","25.4","3368","11.4","3311","11.2","29548","2102","2109","11487","21100","30411","51511","12.7","5.2","49111","69544","20433","17.2","5.0"
"Maryland","1991","1771072","82212","-68770","-3.9","30.4","12653","12.5","11195","11.1","101909","6824","6910","51592","116400","152525","268925","15.2","6.6","227756","337695","109939","19.1","6.2"
"Massachusetts","1991","2655165","114170","-161911","-6.1","25.2","14169","10.2","16621","12.0","137550","10168","10311","77117","128942","204799","333741","12.6","4.9","337793","495652","157859","18.7","5.9"
"Michigan","1991","3323912","150753","-94897","-2.8","27.8","20988","11.3","17816","9.6","186622","11298","11472","87323","191905","269930","461835","13.9","5.8","393061","556732","163671","16.7","4.9"
"Minnesota","1991","1814867","82803","-19862","-1.1","29.6","12134","12.2","9100","9.2","100739","5633","5714","52820","112187","155843","268030","14.8","6.2","190041","287892","97851","15.9","5.4"
"Mississippi","1991","729352","39116","9364","1.2","29.4","5874","12.4","4921","10.4","47929","3118","3140","20628","48507","67778","116285","15.9","6.7","71308","106921","35613","14.7","4.9"
"Missouri","1991","1975910","95513","18261","0.9","31.4","14140","12.2","12084","10.4","117251","7544","7647","54642","119509","209037","328546","16.6","6.0","204736","310285","105549","15.7","5.3"
"Montana","1991","220000","19299","3250","1.5","30.8","2808","12.8","2105","9.6","22338","1397","1408","7192","15863","21284","37147","16.9","7.2","22702","33897","11195","15.4","5.1"
"Nebraska","1991","585726","33400","14076","2.4","25.2","4464","11.3","3429","8.7","40077","2231","2264","14503","35081","52838","87919","15.0","6.0","50048","73843","23795","12.6","4.1"
"Nevada","1991","542356","22934","8245","1.6","34.2","4527","17.1","2992","11.3","27226","1936","1953","17740","39713","61499","101212","18.7","7.3","65581","92967","27386","17.1","5.0"
"New Hampshire","1991","423405","24446","-25411","-6.0","26.8","3439","12.0","3841","13.4","28472","2493","2517","17074","25233","31509","56742","13.4","6.0","53568","82153","28585","19.4","6.8"
"New Jersey","1991","3124754","158005","-130749","-4.2","28.8","20917","11.3","21786","11.8","184425","13612","13722","87088","175021","275783","450804","14.4","5.6","402780","581553","178773","18.6","5.7"
"New Mexico","1991","417522","27094","14707","3.5","33.2","4573","14.4","3459","10.9","32331","2116","2129","14617","38940","44965","83905","20.1","9.3","42269","69198","26929","16.6","6.4"
"New York","1991","6859689","350517","-273250","-4.0","27.4","47197","11.6","46332","11.4","407232","31048","31215","202918","372391","568277","940668","13.7","5.4","844698","1213918","369220","17.7","5.4"
"North Carolina","1991","2614322","118321","-90655","-3.4","27.6","18112","12.3","15405","10.5","148645","9695","9829","69780","152642","207665","360307","13.8","5.8","307939","450962","143023","17.2","5.5"
"North Dakota","1991","197234","14520","5786","2.9","26.6","1811","10.7","1536","9.1","17091","977","981","5615","13472","18456","31928","16.2","6.8","17294","26142","8848","13.3","4.5"
"Ohio","1991","4196084","176311","-65158","-1.6","27.0","24149","10.8","20380","9.1","225884","12631","12760","103279","222206","345493","567699","13.5","5.3","435586","632857","197271","15.1","4.7"
"Oklahoma","1991","944302","55933","10735","1.2","31.2","8695","13.0","6719","10.1","67825","4316","4351","28679","66400","91880","158280","16.8","7.0","96903","147545","50642","15.6","5.4"
"Oregon","1991","1011444","60664","22790","2.3","33.0","10174","14.2","7709","10.8","72684","4868","4955","30992","78666","111264","189930","18.8","7.8","107468","167140","59672","16.5","5.9"
"Pennsylvania","1991","4538975","205750","-59588","-1.3","27.6","26772","10.6","23304","9.3","253646","14753","14985","107675","243293","381163","624456","13.8","5.4","460925","684044","223119","15.1","4.9"
"Rhode Island","1991","383606","21104","-17344","-4.5","26.4","2439","10.2","2896","12.1","23742","1836","1856","11803","21496","28973","50469","13.2","5.6","48081","67813","19732","17.7","5.1"
"South Carolina","1991","1236964","58022","-16458","-1.3","30.8","9557","13.4","7265","10.2","72468","4482","4531","32133","89557","100933","190490","15.4","7.2","140946","206948","66002","16.7","5.3"
"South Dakota","1991","218618","15927","11847","5.4","24.8","2208","12.2","1526","8.4","18430","988","989","5264","16034","22860","38894","17.8","7.3","18429","27047","8618","12.4","3.9"
"Tennessee","1991","1853527","81672","-12427","-0.7","32.0","12947","12.7","10592","10.4","103073","6708","6785","53053","130950","165593","296543","16.0","7.1","208176","308970","100794","16.7","5.4"
"Texas","1991","5857767","277327","124101","2.1","34.8","50053","14.2","38985","11.1","357380","24110","24492","214374","467778","676692","1144470","19.5","8.0","627266","1020369","393103","17.4","6.7"
"Utah","1991","579626","27233","29671","5.1","30.2","4739","14.6","3307","10.2","33225","2065","2082","18817","44450","72546","116996","20.2","7.7","57012","87325","30313","15.1","5.2"
"Vermont","1991","210592","15232","-9961","-4.8","25.2","1858","10.8","1832","10.7","17207","1192","1197","6894","11213","15405","26618","12.6","5.3","25417","36579","11162","17.4","5.3"
"Virginia","1991","2266314","104776","-87329","-3.9","29.2","16840","12.6","15030","11.3","134097","9026","9141","62711","145398","185934","331332","14.6","6.4","284683","418661","133978","18.5","5.9"
"Washington","1991","1727614","98342","21672","1.2","34.6","17247","14.9","12110","10.5","118435","7441","7515","48589","121174","198564","319738","18.5","7.0","193747","298066","104319","17.3","6.0"
"West Virginia","1991","481431","28321","2570","0.6","29.4","3985","11.7","3257","9.6","34474","2052","2073","13523","33305","40178","73483","15.3","6.9","48865","70913","22048","14.7","4.6"
"Wisconsin","1991","1931269","92050","11906","0.7","26.0","12429","11.3","9237","8.4","111392","6022","6113","43264","103347","160511","263858","13.7","5.4","175739","251952","76213","13.0","3.9"
"Wyoming","1991","132036","11227","5478","4.2","28.8","1681","13.2","1179","9.2","13014","759","762","3866","9213","15315","24528","18.6","7.0","13299","19050","5751","14.4","4.4"
"Alabama","1992","1346402","63918","22863","1.7","29.4","10063","12.6","8215","10.3","80283","5494","5574","37434","76427","144192","220619","16.4","5.7","130663","197756","67093","14.7","5.0"
"Alaska","1992","162050","10879","4733","2.9","38.6","1968","15.1","1419","10.9","13231","846","860","5463","12401","23607","36008","22.2","7.7","21776","31275","9499","19.3","5.9"
"Arizona","1992","1248051","63128","3555","0.3","39.0","11685","14.9","10040","12.8","78859","6257","6434","43024","99526","147052","246578","19.8","8.0","144297","243023","98726","19.5","7.9"
"Arkansas","1992","773067","41160","20846","2.7","29.0","6354","12.9","5200","10.6","49488","3558","3614","21298","44686","88407","133093","17.2","5.8","74141","112247","38106","14.5","4.9"
"California","1992","10732102","529679","-262987","-2.4","37.0","87403","13.3","85165","12.9","656532","54681","55671","436805","813263","1167373","1980636","18.5","7.6","1446519","2243623","797104","20.9","7.4"
"Colorado","1992","1292916","74094","45182","3.5","32.4","12983","14.7","10311","11.7","89165","6499","6612","45003","100552","153987","254539","19.7","7.8","124674","209357","84683","16.2","6.5"
"Connecticut","1992","1423706","67353","-35927","-2.5","27.8","8432","10.5","9147","11.4","79633","5837","5916","36640","68031","129540","197571","13.9","4.8","161184","233498","72314","16.4","5.1"
"Delaware","1992","306365","14035","-9554","-3.2","29.0","2285","13.7","1872","11.2","16883","1078","1084","6205","16844","27691","44535","14.5","5.5","33349","54089","20740","17.7","6.8"
"District of Columbia","1992","394956","14639","14470","3.7","29.4","1985","11.2","1784","10.1","17712","1001","1015","8118","36171","36535","72706","18.4","9.2","41594","58236","16642","14.7","4.2"
"Florida","1992","4541774","263140","28664","0.6","38.6","50409","15.7","42391","13.2","324622","28019","28545","186814","383699","520326","904025","19.9","8.4","513836","875361","361525","19.3","8.0"
"Geogia","1992","2476106","113048","55946","2.2","33.4","20113","14.1","16666","11.7","143866","10233","10466","78970","180370","287942","468312","18.9","7.3","242903","412366","169463","16.7","6.8"
"Hawaii","1992","441837","21464","10352","2.3","30.2","3140","11.6","2794","10.3","27167","1756","1788","10274","25427","51436","76863","17.4","5.8","46029","66511","20482","15.1","4.6"
"Idaho","1992","315744","21016","18175","5.7","29.8","3552","14.5","2485","10.1","24955","1591","1611","9548","26722","38474","65196","20.6","8.5","31044","47021","15977","14.9","5.1"
"Illinois","1992","4579284","202758","51809","1.1","30.8","28583","11.6","24543","10.0","247905","15142","15396","108970","274538","481416","755954","16.5","6.0","478625","704145","225520","15.4","4.9"
"Indiana","1992","2130456","94728","48165","2.3","27.8","13643","11.5","11239","9.5","119531","7282","7408","51973","129067","216178","345245","16.2","6.1","198404","297080","98676","13.9","4.6"
"Iowa","1992","1023283","55206","7012","0.6","29.2","7059","10.4","5932","8.8","68184","3821","3875","24541","57266","98748","156014","15.2","5.6","101537","149002","47465","14.6","4.6"
"Kansas","1992","883294","49393","7652","0.9","30.0","7109","11.9","5939","9.9","60233","3831","3893","26719","53039","87064","140103","15.9","6.0","86313","132451","46138","15.0","5.2"
"Kentucky","1992","1189978","59039","13396","1.2","28.2","8704","12.0","7525","10.4","72943","5114","5174","33801","63288","118443","181731","15.3","5.3","109703","168335","58632","14.1","4.9"
"Louisiana","1992","1284338","65815","23100","1.8","33.6","9854","12.1","8308","10.2","82139","5292","5421","40216","80995","157263","238258","18.6","6.3","140854","215158","74304","16.8","5.8"
"Maine","1992","391145","24977","-7436","-1.9","28.6","3375","11.4","3238","11.0","29470","2054","2093","10969","20899","35180","56079","14.3","5.3","40819","63515","22696","16.2","5.8"
"Maryland","1992","1723791","82786","-23412","-1.3","33.2","12701","12.4","11132","10.8","103147","6609","6755","46573","107603","177908","285511","16.6","6.2","211554","308923","97369","17.9","5.6"
"Massachusetts","1992","2559000","112484","-26547","-1.0","30.0","14705","10.7","14970","10.9","136582","9271","9426","66267","135569","247915","383484","15.0","5.3","274518","410031","135513","16.0","5.3"
"Michigan","1992","3301018","152282","51728","1.6","28.4","21177","11.2","17652","9.4","189397","10678","10834","76009","167285","352978","520263","15.8","5.1","318133","468535","150402","14.2","4.6"
"Minnesota","1992","1822713","83751","40947","2.3","27.4","12065","11.9","9970","9.8","102474","6204","6324","44057","97946","193085","291031","16.0","5.4","162508","250084","87576","13.7","4.8"
"Mississippi","1992","734471","39423","10177","1.4","29.2","5798","12.0","5075","10.5","48416","3314","3354","19983","37542","79676","117218","16.0","5.1","71606","107041","35435","14.6","4.8"
"Missouri","1992","1987304","96336","12024","0.6","30.0","14246","12.1","12404","10.5","118633","7913","8040","48897","108320","202522","310842","15.6","5.5","200978","298818","97840","15.0","4.9"
"Montana","1992","228382","19780","14356","6.3","27.2","3069","13.5","2302","10.1","23061","1533","1548","7912","15091","30292","45383","19.9","6.6","18877","31027","12150","13.6","5.3"
"Nebraska","1992","594127","33831","10924","1.8","26.6","4442","11.0","3692","9.1","40666","2366","2411","14040","30305","59437","89742","15.1","5.1","53424","78818","25394","13.3","4.3"
"Nevada","1992","546736","23416","76","0.0","33.8","4589","16.6","3592","13.0","28079","2343","2367","16144","39364","53012","92376","16.9","7.2","61823","92300","30477","16.9","5.6"
"New Hampshire","1992","411639","24211","3027","0.7","31.6","3616","12.7","3332","11.7","28590","2250","2292","13925","25656","42450","68106","16.5","6.2","42541","65079","22538","15.8","5.5"
"New Jersey","1992","3044202","157103","-6828","-0.2","33.0","21104","11.4","20403","11.1","183921","12842","12978","73121","159478","342884","502362","16.5","5.2","345252","509190","163938","16.7","5.4"
"New Mexico","1992","428861","27468","13445","3.1","35.6","4599","14.1","3677","11.2","33023","2278","2322","13989","34614","55221","89835","20.9","8.1","49103","76390","27287","17.8","6.4"
"New York","1992","6676973","345484","-17058","-0.3","32.2","46121","11.4","47403","11.7","403364","32517","33001","197188","381653","694328","1075981","16.1","5.7","724405","1093039","368634","16.4","5.5"
"North Carolina","1992","2596790","119096","61582","2.4","28.0","17939","12.0","15352","10.2","150549","9813","9961","60525","149148","276156","425304","16.4","5.7","231911","363722","131811","14.0","5.1"
"North Dakota","1992","202318","14514","5428","2.7","25.8","1825","10.6","1612","9.4","17226","1047","1060","5142","10931","20572","31503","15.6","5.4","17126","26075","8949","12.9","4.4"
"Ohio","1992","4161441","176694","6575","0.2","28.2","23913","10.5","21555","9.5","227682","13219","13463","86135","194745","398528","593273","14.3","4.7","405152","586698","181546","14.1","4.4"
"Oklahoma","1992","950584","56510","5197","0.6","32.6","8789","12.8","7390","10.8","68949","5040","5130","31593","59875","100375","160250","16.9","6.3","96074","155053","58979","16.3","6.2"
"Oregon","1992","1022136","61952","4567","0.5","34.0","10166","13.8","8043","10.9","74465","5131","5196","32875","68390","110034","178424","17.5","6.7","114525","173857","59332","17.0","5.8"
"Pennsylvania","1992","4488384","204368","-29151","-0.6","28.4","25601","10.1","24738","9.7","253696","15873","16115","103202","227241","408920","636161","14.2","5.1","450509","665312","214803","14.8","4.8"
"Rhode Island","1992","367863","20701","-10405","-2.8","28.2","2590","11.0","2734","11.6","23354","1775","1803","12307","18093","33760","51853","14.1","4.9","40029","62258","22229","16.9","6.0"
"South Carolina","1992","1241171","58601","19595","1.6","28.8","9238","12.6","7882","10.8","73449","5055","5122","31848","75754","122930","198684","16.0","6.1","120346","179089","58743","14.4","4.7"
"South Dakota","1992","229407","16093","9383","4.1","26.6","2201","11.8","1815","9.7","18764","1185","1196","6948","13577","26383","39960","17.4","5.9","19060","30577","11517","13.3","5.0"
"Tennessee","1992","1868443","82534","49032","2.6","29.2","13044","12.6","11228","10.8","104471","7132","7246","49124","109151","212388","321539","17.2","5.8","172625","272507","99882","14.6","5.3"
"Texas","1992","5950058","282598","87351","1.4","36.0","51501","14.2","42127","11.6","365314","26555","27201","206550","470128","685998","1156126","19.4","7.9","670520","1068775","398255","18.0","6.7"
"Utah","1992","603564","28181","18411","3.1","33.0","4999","14.8","3789","11.2","34343","2414","2449","23583","43472","74799","118271","19.6","7.2","58678","99860","41182","16.5","6.8"
"Vermont","1992","205790","15163","1856","0.9","28.6","1903","11.1","1776","10.3","17195","1194","1200","6082","11337","19910","31247","15.2","5.5","20256","29391","9135","14.3","4.4"
"Virginia","1992","2231301","105795","14643","0.7","32.2","17097","12.7","14825","11.0","135803","8969","9197","62989","141088","233206","374294","16.8","6.3","233861","359651","125790","16.1","5.6"
"Washington","1992","1761545","101511","53618","3.0","34.0","18240","15.1","13279","11.0","122631","8458","8554","50743","119751","232890","352641","20.0","6.8","189696","299023","109327","17.0","6.2"
"West Virginia","1992","481350","28485","-2090","-0.4","30.2","3828","11.0","3382","9.8","34743","2104","2121","12299","25278","47471","72749","15.1","5.3","47951","74839","26888","15.5","5.6"
"Wisconsin","1992","1954788","92741","31684","1.7","24.6","11883","10.6","10101","9.0","112804","6406","6480","38972","86215","186864","273079","14.0","4.4","162265","241395","79130","12.3","4.0"
"Wyoming","1992","135874","11513","2469","1.8","33.0","1710","13.0","1301","9.9","13338","757","764","4371","8672","16239","24911","18.3","6.4","15033","22442","7409","16.5","5.5"
"Alabama","1993","1383184","65394","38377","2.7","26.0","9482","11.7","7837","9.7","81689","5343","5360","31016","64949","152736","217685","15.7","4.7","118110","179308","61198","13.0","4.4"
"Alaska","1993","165637","11184","2939","1.8","34.6","1737","13.0","1451","10.9","13481","840","848","4586","9464","22174","31638","19.1","5.7","19551","28699","9148","17.3","5.5"
"Arizona","1993","1274754","65112","47591","3.7","31.8","11194","14.0","9275","11.6","80516","5987","6028","37389","90983","158866","249849","19.6","7.1","124075","202258","78183","15.9","6.1"
"Arkansas","1993","797039","42387","29920","3.8","25.2","6164","12.3","4870","9.7","50628","3445","3489","18979","42142","88275","130417","16.4","5.3","64749","100497","35748","12.6","4.5"
"California","1993","10547691","523374","-47978","-0.5","36.2","75603","11.6","82362","12.7","645597","53343","54099","337326","669902","1242824","1912726","18.1","6.4","1242754","1960704","717950","18.6","6.8"
"Colorado","1993","1345000","77907","63853","4.7","28.8","13173","14.5","9490","10.4","92656","6093","6127","35660","86970","170260","257230","19.1","6.5","120298","193377","73079","14.4","5.4"
"Connecticut","1993","1402788","67538","-3378","-0.3","29.4","7808","9.8","7696","9.7","79579","5023","5054","29100","59721","146873","206594","14.7","4.3","149841","209972","60131","15.0","4.3"
"Delaware","1993","302401","14343","2399","0.8","29.8","2026","11.9","1745","10.3","17100","1045","1047","6557","16479","30980","47459","15.7","5.4","29605","45060","15455","14.9","5.1"
"District of Columbia","1993","414809","14585","24955","6.0","25.8","1618","9.2","1813","10.3","17491","927","931","6106","16050","62321","78371","18.9","3.9","35354","53416","18062","12.9","4.4"
"Florida","1993","4644368","272178","172661","3.7","33.8","48544","14.8","39997","12.2","332350","27778","28105","175123","368147","589430","957577","20.6","7.9","472521","784916","312395","16.9","6.7"
"Geogia","1993","2540489","117021","74297","3.0","29.4","19231","13.2","15262","10.5","147510","9955","10003","66232","162589","286128","448717","17.7","6.4","238751","374420","135669","14.7","5.3"
"Hawaii","1993","438664","21464","-14815","-3.3","27.0","2824","10.4","2806","10.4","27064","1840","1848","10282","21333","37688","59021","13.5","4.9","51749","73836","22087","16.8","5.0"
"Idaho","1993","329085","21841","9744","2.9","30.0","3427","13.5","2518","9.9","25761","1644","1646","9368","20819","38181","59000","17.9","6.3","33003","49256","16253","15.0","4.9"
"Illinois","1993","4609541","206074","24297","0.5","29.2","26409","10.6","22911","9.2","250735","14781","14889","89863","233014","462017","695031","15.1","5.1","465584","670734","205150","14.6","4.5"
"Indiana","1993","2180336","96817","53071","2.5","24.8","12591","10.5","10483","8.7","121418","7089","7135","43290","94277","230055","324332","14.9","4.3","184321","271261","86940","12.4","4.0"
"Iowa","1993","1035736","55783","18846","1.8","23.0","6226","9.1","5617","8.2","68639","3768","3787","19290","41013","96802","137815","13.3","4.0","83208","118969","35761","11.5","3.5"
"Kansas","1993","891512","50181","10310","1.2","26.6","6421","10.6","5599","9.2","60925","3722","3753","21944","41789","87268","129057","14.5","4.7","79294","118747","39453","13.3","4.4"
"Kentucky","1993","1216362","60115","41043","3.4","25.4","8334","11.3","7173","9.8","73934","4861","4885","28067","66685","129303","195988","16.1","5.5","98841","154945","56104","12.7","4.6"
"Louisiana","1993","1301148","67301","13110","1.0","31.8","9085","11.0","7729","9.3","83407","5236","5260","38046","73452","146961","220413","16.9","5.6","139858","207303","67445","15.9","5.2"
"Maine","1993","395352","25253","16878","4.3","25.2","3264","11.0","2906","9.8","29690","1917","1940","9508","24220","42433","66653","16.9","6.1","31835","49775","17940","12.6","4.5"
"Maryland","1993","1708351","84307","-3465","-0.2","31.6","11932","11.5","10935","10.6","103875","6522","6583","45729","95294","174121","269415","15.8","5.6","181703","272880","91177","16.0","5.3"
"Massachusetts","1993","2567055","113330","45321","1.8","27.8","13717","10.0","13077","9.6","136982","8411","8519","51185","125931","276078","402009","15.7","4.9","240064","356688","116624","13.9","4.5"
"Michigan","1993","3361977","154549","75062","2.2","25.8","19527","10.3","17211","9.0","191270","11274","11357","67692","154486","352923","507409","15.1","4.6","297381","432347","134966","12.9","4.0"
"Minnesota","1993","1874729","86216","62311","3.3","24.6","11352","11.0","8712","8.4","104867","5627","5693","36385","98980","193009","291989","15.6","5.3","154193","229678","75485","12.3","4.0"
"Mississippi","1993","754275","40418","28640","3.8","26.0","5852","12.0","4752","9.7","49450","3410","3418","20646","45463","81202","126665","16.8","6.0","60025","98025","38000","13.0","5.0"
"Missouri","1993","1999829","98232","14017","0.7","28.0","13511","11.3","11697","9.8","120257","7881","7949","49493","95582","198719","294301","14.7","4.8","183353","280284","96931","14.0","4.8"
"Montana","1993","238202","20244","8018","3.4","29.4","2807","12.1","2319","10.0","23467","1586","1596","7884","15731","27331","43062","18.1","6.6","23209","35044","11835","14.7","5.0"
"Nebraska","1993","606482","34218","14062","2.3","24.0","4003","9.8","3553","8.7","41023","2398","2409","11995","26530","60324","86854","14.3","4.4","51266","72792","21526","12.0","3.5"
"Nevada","1993","557565","24180","23620","4.3","28.0","4404","15.5","3532","12.4","28788","2289","2322","17443","40568","61302","101870","18.3","7.3","48629","78250","29621","14.0","5.3"
"New Hampshire","1993","416203","24402","6845","1.6","27.6","3244","11.3","3006","10.5","28745","1976","1984","9353","21454","42630","64084","15.4","5.2","37349","57239","19890","13.8","4.8"
"New Jersey","1993","3051256","159542","14800","0.5","31.4","20496","11.1","18032","9.7","186014","11983","12029","64480","153993","339327","493320","16.2","5.0","329039","478520","149481","15.7","4.9"
"New Mexico","1993","442894","28429","15346","3.5","30.4","4252","12.7","3395","10.2","33868","2255","2258","11832","28707","54137","82844","18.7","6.5","44147","67498","23351","15.2","5.3"
"New York","1993","6618134","346038","-61299","-0.9","30.4","44518","11.0","43521","10.8","403359","30398","30582","165063","339819","666967","1006786","15.2","5.1","747120","1068085","320965","16.1","4.8"
"North Carolina","1993","2665585","121364","71423","2.6","25.2","16716","11.0","14088","9.3","152781","9465","9536","56224","124381","281672","406053","15.2","4.7","224092","334630","110538","12.6","4.1"
"North Dakota","1993","208522","14735","6981","3.3","22.4","1696","9.8","1431","8.3","17451","976","978","4535","9879","20447","30326","14.5","4.7","15701","23345","7644","11.2","3.7"
"Ohio","1993","4206104","179233","83978","2.0","25.8","22123","9.7","20558","9.0","228860","12654","12784","77428","191069","436939","628008","14.9","4.5","362644","544030","181386","12.9","4.3"
"Oklahoma","1993","964462","57797","23456","2.4","28.2","8068","11.6","6921","10.0","69955","4652","4674","24824","56347","102832","159179","16.5","5.8","87382","135723","48341","14.1","5.0"
"Oregon","1993","1038875","63624","29372","2.9","29.0","9445","12.6","7806","10.4","75844","5056","5084","25547","59020","121397","180417","17.4","5.7","99097","151045","51948","14.5","5.0"
"Pennsylvania","1993","4486581","204517","23621","0.6","26.6","22871","9.0","22817","9.0","253027","15039","15156","91771","199415","422690","622105","13.9","4.4","412034","598484","186450","13.3","4.2"
"Rhode Island","1993","367391","21054","9383","2.5","26.2","2581","11.0","2234","9.5","23688","1463","1468","7915","21994","35480","57474","15.6","6.0","31063","48091","17028","13.1","4.6"
"South Carolina","1993","1264276","59863","23204","1.8","25.8","8759","11.8","7283","9.8","74751","4886","4910","25552","63611","122805","186416","14.7","5.0","107607","163212","55605","12.9","4.4"
"South Dakota","1993","239186","16460","10361","4.4","24.2","2029","10.7","1650","8.7","19109","1115","1125","5551","14321","25097","39418","16.5","6.0","18381","29057","10676","12.1","4.5"
"Tennessee","1993","1918641","84669","53071","2.8","27.2","12427","11.8","10128","9.6","106500","6705","6787","42833","102637","212275","314912","16.4","5.3","176702","261841","85139","13.6","4.4"
"Texas","1993","6078760","290051","177541","2.9","33.2","47588","12.9","40533","11.0","371330","26186","26434","182144","410514","773750","1184264","19.5","6.8","632901","1006723","373822","16.6","6.1"
"Utah","1993","630258","29422","35359","5.6","25.8","4941","14.1","3617","10.4","35529","2383","2397","18113","38700","78102","116802","18.5","6.1","47682","81443","33761","12.9","5.4"
"Vermont","1993","210647","15434","6338","3.0","23.8","1932","11.2","1660","9.6","17460","1142","1144","5405","10379","21054","31433","14.9","4.9","15604","25095","9491","11.9","4.5"
"Virginia","1993","2310575","108229","148420","6.4","27.6","15718","11.5","13294","9.7","137903","8403","8458","48035","127448","339997","467445","20.2","5.5","214779","319025","104246","13.8","4.5"
"Washington","1993","1817669","104643","24183","1.3","30.8","16684","13.4","13251","10.7","125528","8618","8687","48839","106150","198210","304360","16.7","5.8","183494","280177","96683","15.4","5.3"
"West Virginia","1993","483328","28810","6859","1.4","26.6","3487","10.0","3143","9.0","35012","2091","2107","11248","21231","49775","71006","14.7","4.4","42815","64147","21332","13.3","4.4"
"Wisconsin","1993","1999055","94771","56480","2.8","23.2","11771","10.3","9501","8.3","114878","6420","6497","39149","89099","198534","287633","14.4","4.5","153393","231153","77760","11.6","3.9"
"Wyoming","1993","139356","11868","3001","2.1","32.2","1855","13.7","1337","9.8","13822","876","885","4694","10617","14803","25420","18.2","7.6","14785","22419","7634","16.1","5.5"
"Alabama","1994","1415009","67204","32211","2.3","26.8","10389","12.6","8070","9.8","83751","5492","5518","36087","84306","137362","221668","15.7","6.0","125798","189457","63659","13.4","4.5"
"Alaska","1994","169205","11511","4590","2.7","34.8","1814","13.3","1437","10.5","13796","841","847","3908","12698","21317","34015","20.1","7.5","20172","29425","9253","17.4","5.5"
"Arizona","1994","1341461","67685","89525","6.7","30.2","12639","15.4","9122","11.1","83748","6185","6204","39110","113564","178619","292183","21.8","8.5","124770","202658","77888","15.1","5.8"
"Arkansas","1994","821074","43467","20994","2.6","27.4","6622","12.9","5046","9.8","52021","3616","3628","24531","52223","81528","133751","16.3","6.4","67422","112757","45335","13.7","5.5"
"California","1994","10483851","522330","-41160","-0.4","34.4","80453","12.5","79079","12.3","643643","51095","51500","361010","700042","1101752","1801794","17.2","6.7","1159984","1842954","682970","17.6","6.5"
"Colorado","1994","1404918","81787","58633","4.2","29.6","14746","15.5","9880","10.4","97238","6642","6670","39229","104037","162739","266776","19.0","7.4","128093","208143","80050","14.8","5.7"
"Connecticut","1994","1386909","67788","-18653","-1.3","27.6","8129","10.2","7555","9.5","79927","4994","5017","37964","61086","129755","190841","13.8","4.4","140147","209494","69347","15.1","5.0"
"Delaware","1994","316508","14714","25428","8.0","29.0","2201","12.7","1670","9.6","17592","1022","1022","5436","17330","53962","71292","22.5","5.5","33954","45864","11910","14.5","3.8"
"District of Columbia","1994","419062","14706","-22156","-5.3","25.6","1787","10.2","1568","8.9","17665","903","924","5120","19632","34180","53812","12.8","4.7","61232","75968","14736","18.1","3.5"
"Florida","1994","4817216","278292","195039","4.1","31.4","49400","14.7","40623","12.1","339954","28951","29079","175612","369007","583144","952151","19.8","7.7","468058","757112","289054","15.7","6.0"
"Geogia","1994","2625414","120395","114827","4.4","27.6","20675","13.8","16053","10.7","151723","10626","10682","66569","181930","294747","476677","18.2","6.9","221311","361850","140539","13.8","5.4"
"Hawaii","1994","426549","21493","-8562","-2.0","28.4","2794","10.3","2674","9.9","27075","1746","1780","13709","26245","34311","60556","14.2","6.2","43775","69118","25343","16.2","5.9"
"Idaho","1994","344819","23087","22961","6.7","26.6","4031","15.2","2519","9.5","27136","1702","1713","9791","25521","43306","68827","20.0","7.4","29065","45866","16801","13.3","4.9"
"Illinois","1994","4674579","209382","116936","2.5","25.4","27674","10.9","22759","9.0","254937","14934","14986","95938","244959","467280","712239","15.2","5.2","398277","595303","197026","12.7","4.2"
"Indiana","1994","2233858","98822","53281","2.4","25.2","13463","11.0","10684","8.7","123919","7144","7190","41701","112216","223133","335349","15.0","5.0","184433","282068","97635","12.6","4.4"
"Iowa","1994","1054185","56457","21799","2.1","23.6","6899","10.0","5752","8.3","69542","3879","3893","20341","49070","97634","146704","13.9","4.7","80470","124905","44435","11.8","4.2"
"Kansas","1994","911281","51161","30007","3.3","25.0","7055","11.5","5763","9.4","62065","3875","3920","21570","51368","92372","143740","15.8","5.6","73440","113733","40293","12.5","4.4"
"Kentucky","1994","1253328","61120","34563","2.7","26.0","8584","11.5","7037","9.4","75269","4848","4862","30478","71825","125422","197247","15.7","5.7","108741","162684","53943","13.0","4.3"
"Louisiana","1994","1324235","68703","38340","2.9","28.4","10009","11.9","8060","9.6","85118","5422","5452","34384","83022","143098","226120","17.1","6.3","126679","187780","61101","14.2","4.6"
"Maine","1994","405680","25592","6092","1.5","27.8","3454","11.6","2885","9.6","30119","2003","2007","11389","21311","41114","62425","15.4","5.3","36937","56333","19396","13.9","4.8"
"Maryland","1994","1715818","85659","23826","1.4","30.2","12274","11.7","10447","10.0","105413","6504","6575","40183","100420","183284","283704","16.5","5.9","171149","259878","88729","15.1","5.2"
"Massachusetts","1994","2600319","115026","25982","1.0","28.0","14973","10.9","12678","9.2","138955","8193","8227","56955","124243","266446","390689","15.0","4.8","247078","364707","117629","14.0","4.5"
"Michigan","1994","3444715","157355","86448","2.5","26.0","20743","10.7","16779","8.7","194789","11186","11307","73811","180540","352359","532899","15.5","5.2","283033","446451","163418","13.0","4.7"
"Minnesota","1994","1929655","88527","52922","2.8","24.0","12103","11.4","8942","8.4","107753","5858","5884","40071","94187","191082","285269","14.8","4.9","152708","232347","79639","12.0","4.1"
"Mississippi","1994","791400","40993","49445","6.3","25.2","6016","12.1","5173","10.4","50131","3688","3704","19477","62745","86608","149353","18.9","7.9","63045","99908","36863","12.6","4.7"
"Missouri","1994","2035599","100222","58351","2.9","25.6","14935","12.3","12102","10.0","122714","8293","8322","49093","109709","209556","319265","15.7","5.4","168902","260914","92012","12.8","4.5"
"Montana","1994","244093","20871","2449","1.0","30.6","3088","13.0","2292","9.6","24169","1615","1615","7487","15227","24591","39818","16.3","6.2","24687","37369","12682","15.3","5.2"
"Nebraska","1994","620506","34734","16203","2.6","24.4","4384","10.6","3548","8.6","41715","2421","2429","13544","33018","58728","91746","14.8","5.3","47630","75543","27913","12.2","4.5"
"Nevada","1994","594536","25550","51236","8.6","27.2","5006","16.9","3372","11.4","30321","2298","2304","22040","47095","85183","132278","22.2","7.9","46847","81042","34195","13.6","5.8"
"New Hampshire","1994","428459","24930","18710","4.3","25.0","3642","12.5","2896","10.0","29374","1922","1923","9644","24228","47905","72133","16.8","5.7","33632","53423","19791","12.5","4.6"
"New Jersey","1994","3059172","161132","8278","0.2","30.0","21358","11.4","18728","10.0","188124","12256","12337","77345","166225","299476","465701","15.2","5.4","298836","457423","158587","15.0","5.2"
"New Mexico","1994","459751","29254","20151","4.4","29.6","4758","13.8","3581","10.4","34918","2489","2497","14218","33715","54612","88327","19.2","7.3","42473","68176","25703","14.8","5.6"
"New York","1994","6575682","346091","-8248","-0.1","29.2","45895","11.4","43644","10.8","404479","30401","30566","176252","337489","623601","961090","14.6","5.1","649638","969338","319700","14.7","4.9"
"North Carolina","1994","2752790","124616","108876","3.9","23.6","18552","12.0","13896","9.0","156906","9470","9514","58547","154076","279300","433376","15.7","5.6","214144","324500","110356","11.8","4.0"
"North Dakota","1994","214997","14999","6270","2.9","22.6","1747","9.9","1437","8.2","17739","978","980","4376","9451","21169","30620","14.2","4.4","16863","24350","7487","11.3","3.5"
"Ohio","1994","4273013","182111","104410","2.5","25.0","24152","10.5","19761","8.6","232762","12673","12805","77492","222206","416843","639049","15.0","5.2","362842","534639","171797","12.5","4.0"
"Oklahoma","1994","985381","59055","20535","2.1","28.0","8687","12.3","6913","9.8","71479","4906","4911","27235","57988","100754","158742","16.1","5.9","90305","138207","47902","14.0","4.9"
"Oregon","1994","1080056","66290","55003","5.1","26.4","11027","14.2","7610","9.8","79009","5071","5084","26370","74720","122952","197672","18.3","6.9","91302","142669","51367","13.2","4.8"
"Pennsylvania","1994","4500087","204123","26450","0.6","26.6","23743","9.4","22356","8.8","253624","14883","14995","100223","219667","406953","626620","13.9","4.9","393320","600170","206850","13.3","4.6"
"Rhode Island","1994","369123","21332","-6723","-1.8","29.0","2666","11.2","2385","10.0","23939","1601","1605","9608","21981","31369","53350","14.5","6.0","40436","60073","19637","16.3","5.3"
"South Carolina","1994","1295372","60991","43983","3.4","26.0","9211","12.2","7440","9.9","76229","5042","5059","32212","84016","127979","211995","16.4","6.5","106686","168012","61326","13.0","4.7"
"South Dakota","1994","248034","16860","8500","3.4","25.4","2288","11.8","1685","8.7","19622","1175","1178","7284","15416","24591","40007","16.1","6.2","19539","31507","11968","12.7","4.8"
"Tennessee","1994","1974443","86567","62336","3.2","26.2","12984","12.1","10231","9.5","108939","6919","6955","45748","122031","199078","321109","16.3","6.2","162699","258773","96074","13.1","4.9"
"Texas","1994","6221921","297469","131059","2.1","31.8","50661","13.5","40123","10.7","380583","26915","27054","172658","432105","688167","1120272","18.0","6.9","641411","989213","347802","15.9","5.6"
"Utah","1994","668105","31010","41864","6.3","25.8","5781","15.9","3802","10.4","37419","2613","2622","19701","47354","80777","128131","19.2","7.1","51936","86267","34331","12.9","5.1"
"Vermont","1994","215493","15671","3892","1.8","24.4","1922","10.9","1583","9.0","17725","1082","1087","4970","9996","20098","30094","14.0","4.6","17024","26202","9178","12.2","4.3"
"Virginia","1994","2363292","110799","-39344","-1.7","31.4","16525","11.9","13195","9.5","140918","8361","8400","46036","135017","236694","371711","15.7","5.7","306761","411055","104294","17.4","4.4"
"Washington","1994","1843105","107728","32834","1.7","30.2","17889","14.1","13678","10.7","129097","9127","9150","48116","113646","196688","310334","16.8","6.2","189502","277500","87998","15.1","4.8"
"West Virginia","1994","492295","29426","12089","2.4","26.2","3863","10.9","2961","8.4","35811","1982","1987","10466","27317","49053","76370","15.5","5.5","43217","64281","21064","13.1","4.3"
"Wisconsin","1994","2049898","96234","50639","2.4","22.2","11975","10.3","9661","8.3","116838","6566","6604","38191","94337","183119","277456","13.5","4.6","157547","226817","69270","11.1","3.4"
"Wyoming","1994","143943","12355","6683","4.7","28.0","1862","13.2","1260","8.9","14366","849","851","4112","10682","16201","26883","18.7","7.4","13515","20200","6685","14.0","4.6"
"Alabama","1995","1467007","68976","76074","5.2","23.8","10622","12.5","8166","9.6","85909","5662","5705","33571","86798","164031","250829","17.1","5.9","114755","174755","60000","11.9","4.1"
"Alaska","1995","172692","11847","3337","1.9","32.2","1882","13.5","1472","10.5","14143","943","952","4957","11715","19419","31134","18.0","6.8","18935","27797","8862","16.1","5.1"
"Arizona","1995","1432500","70159","94488","6.6","28.0","12940","15.2","9572","11.2","86610","6436","6540","41490","114600","180298","294898","20.6","8.0","126209","200410","74201","14.0","5.2"
"Arkansas","1995","852651","44595","44355","5.2","23.8","6889","13.1","5251","10.0","53484","3749","3754","23336","50414","95796","146210","17.1","5.9","59964","101855","41891","11.9","4.9"
"California","1995","10614063","526482","314151","2.9","29.6","82358","12.7","73802","11.4","648641","48884","49295","295961","667725","1214349","1882074","17.7","6.3","1006334","1567923","561589","14.8","5.3"
"Colorado","1995","1478714","85450","88993","6.0","28.4","15212","15.3","10433","10.5","101591","6966","6988","42727","119087","179259","298346","20.2","8.1","135302","209353","74051","14.2","5.0"
"Connecticut","1995","1383830","68746","18018","1.3","25.8","8641","10.7","7346","9.1","81012","4784","4839","25884","73542","123492","197034","14.2","5.3","122203","179016","56813","12.9","4.1"
"Delaware","1995","314074","15180","18408","5.9","24.0","2319","13.0","1724","9.7","18141","1087","1092","6034","17283","38797","56080","17.9","5.5","24397","37672","13275","12.0","4.2"
"District of Columbia","1995","407790","14755","61","0.0","28.0","1801","10.2","1653","9.3","17774","923","929","7438","17561","39439","57000","14.0","4.3","39419","56939","17520","14.0","4.3"
"Florida","1995","5010695","283724","218309","4.4","31.4","49651","14.5","41223","12.0","346872","29295","29457","180357","416656","588949","1005605","20.1","8.3","479225","787296","308071","15.7","6.1"
"Geogia","1995","2770099","124444","174545","6.3","26.2","21751","14.1","15910","10.3","156989","10532","10585","71666","211358","326434","537792","19.4","7.6","223038","363247","140209","13.1","5.1"
"Hawaii","1995","421647","21547","1191","0.3","26.8","2864","10.6","2637","9.7","27194","1787","1796","8445","25371","32366","57737","13.7","6.0","37783","56546","18763","13.4","4.4"
"Idaho","1995","361497","24017","12798","3.5","29.0","3978","14.4","2862","10.4","28116","1934","1939","9114","24536","40548","65084","18.0","6.8","30568","52286","21718","14.5","6.0"
"Illinois","1995","4800455","213113","140707","2.9","25.2","28881","11.2","23320","9.1","259721","15017","15104","97424","256602","487428","744030","15.5","5.3","405510","603323","197813","12.6","4.1"
"Indiana","1995","2311145","100740","102301","4.5","22.8","14422","11.5","11140","8.9","126812","7490","7522","43487","126697","239852","366549","15.9","5.5","178947","264248","85301","11.4","3.7"
"Iowa","1995","1086338","57097","44864","4.2","21.2","7122","10.2","5962","8.5","70481","4045","4059","20812","54375","106115","160490","14.8","5.0","72288","115626","43338","10.6","4.0"
"Kansas","1995","940378","52006","31079","3.3","23.2","7112","11.4","5787","9.2","63151","3984","4007","20646","50866","89007","139873","14.9","5.4","70963","108794","37831","11.6","4.0"
"Kentucky","1995","1296623","62220","54301","4.2","24.4","8909","11.7","7091","9.3","76787","4880","4900","30133","76903","136186","213089","16.4","5.9","100684","158788","58104","12.2","4.5"
"Louisiana","1995","1363101","69816","45820","3.4","29.0","9912","11.6","8178","9.5","86523","5486","5540","38899","93466","150414","243880","17.9","6.9","121768","198060","76292","14.5","5.6"
"Maine","1995","414733","26167","12515","3.0","24.2","3646","12.0","2980","9.8","30688","2010","2015","9920","21243","41320","62563","15.1","5.1","33004","50048","17044","12.1","4.1"
"Maryland","1995","1762752","87612","74691","4.2","25.6","13076","12.3","10474","9.8","107686","6763","6809","40782","104957","194488","299445","17.0","6.0","142823","224754","81931","12.8","4.6"
"Massachusetts","1995","2650051","117390","76336","2.9","25.0","16085","11.5","12878","9.2","141833","8204","8279","54833","135246","271749","406995","15.4","5.1","218439","330659","112220","12.5","4.2"
"Michigan","1995","3569755","161096","169206","4.7","24.0","22284","11.3","17149","8.7","199288","11363","11415","72549","210096","387444","597540","16.7","5.9","283342","428334","144992","12.0","4.1"
"Minnesota","1995","1999258","90383","92596","4.7","22.0","12156","11.2","9487","8.7","109932","6068","6108","40151","118805","194194","312999","15.7","5.9","146217","220403","74186","11.0","3.7"
"Mississippi","1995","831653","41773","33004","4.0","26.8","6227","12.3","5015","9.9","51152","3518","3525","22708","58406","86364","144770","17.4","7.0","71615","111766","40151","13.4","4.8"
"Missouri","1995","2098938","101932","73673","3.5","25.6","15006","12.1","12286","9.9","124894","8397","8437","47136","118156","223459","341615","16.3","5.6","174441","267942","93501","12.8","4.5"
"Montana","1995","250389","21493","11610","4.7","25.4","3317","13.5","2393","9.8","24898","1727","1730","8467","17622","25886","43508","17.4","7.0","19174","31898","12724","12.7","5.1"
"Nebraska","1995","642471","35077","29433","4.6","21.2","4256","10.1","3555","8.5","42237","2445","2455","12227","31771","65808","97579","15.2","4.9","44138","68146","24008","10.6","3.7"
"Nevada","1995","640958","26897","43939","6.9","25.4","5405","17.4","3626","11.7","31949","2518","2523","17854","53865","71667","125532","19.6","8.4","52573","81593","29020","12.7","4.5"
"New Hampshire","1995","448680","25726","22207","5.0","23.8","3843","12.9","2870","9.6","30296","1901","1907","10675","30385","45432","75817","16.9","6.8","33492","53610","20118","11.9","4.5"
"New Jersey","1995","3100003","165141","77086","2.4","26.6","23192","12.2","18330","9.6","192419","12236","12338","70479","172419","315791","488210","15.7","5.6","265182","411124","145942","13.3","4.7"
"New Mexico","1995","479681","29917","21662","4.5","27.8","4802","13.6","3798","10.8","35712","2603","2615","14310","33996","54257","88253","18.4","7.1","39874","66591","26717","13.9","5.6"
"New York","1995","6616828","350203","90493","1.4","27.4","47664","11.7","41866","10.3","409210","29255","29371","160425","354752","642421","997173","15.1","5.4","613554","906680","293126","13.7","4.4"
"North Carolina","1995","2876894","128770","135433","4.7","22.4","19740","12.4","14259","8.9","161947","9687","9717","56778","161002","296803","457805","15.9","5.6","212275","322372","110097","11.2","3.8"
"North Dakota","1995","222130","15221","9743","4.4","22.0","1745","9.8","1409","7.9","17983","943","949","4808","10926","23266","34192","15.4","4.9","15620","24449","8829","11.0","4.0"
"Ohio","1995","4403850","185483","168664","3.8","22.8","24995","10.6","20059","8.5","236995","12872","12973","79237","226608","442464","669072","15.2","5.1","337863","500408","162545","11.4","3.7"
"Oklahoma","1995","1008427","59817","28061","2.8","27.0","8568","11.9","7291","10.1","72460","5174","5191","27134","59557","104536","164093","16.3","5.9","84709","136032","51323","13.5","5.1"
"Oregon","1995","1132074","68413","57751","5.1","26.4","11212","14.0","8514","10.6","81318","5654","5716","30651","77017","130604","207621","18.3","6.8","96146","149870","53724","13.2","4.7"
"Pennsylvania","1995","4570932","206887","129065","2.8","23.0","25863","10.1","21523","8.4","257102","14146","14219","91494","225485","429033","654518","14.3","4.9","343312","525453","182141","11.5","4.0"
"Rhode Island","1995","371131","21548","11300","3.0","23.8","2669","11.1","2273","9.4","24250","1552","1560","7546","19387","36049","55436","14.9","5.2","29955","44136","14181","11.9","3.8"
"South Carolina","1995","1342742","62675","52468","3.9","24.4","9858","12.8","7569","9.8","78274","5147","5177","30319","82476","134191","216667","16.1","6.1","104070","164199","60129","12.2","4.5"
"South Dakota","1995","258190","17171","12587","4.8","20.4","2127","10.7","1669","8.4","19969","1163","1164","5405","12469","26356","38825","15.0","4.8","15888","26238","10350","10.2","4.0"
"Tennessee","1995","2071888","88817","129748","6.3","23.4","13707","12.4","10474","9.5","111848","7087","7139","43354","125622","246907","372529","18.0","6.1","160540","242781","82241","11.7","4.0"
"Texas","1995","6437669","304034","311218","4.8","28.8","51671","13.4","41292","10.7","389147","27732","28005","180751","477202","760485","1237687","19.2","7.4","589451","926469","337018","14.4","5.2"
"Utah","1995","710460","32474","45763","6.5","26.2","5943","15.5","4039","10.6","39149","2763","2777","20254","54216","84917","139133","19.6","7.6","59602","93370","33768","13.1","4.8"
"Vermont","1995","219517","15904","4605","2.1","25.6","1927","10.8","1609","9.0","17980","1139","1140","6263","10775","21850","32625","14.9","4.9","16453","28020","11567","12.8","5.3"
"Virginia","1995","2385108","113851","94146","4.0","25.2","17546","12.3","13532","9.5","144500","8710","8755","49887","144859","250679","395538","16.6","6.1","193756","301392","107636","12.6","4.5"
"Washington","1995","1885068","109793","53659","2.9","28.2","18020","13.8","14691","11.3","131600","9931","10012","56470","123155","197005","320160","17.0","6.5","168647","266501","97854","14.1","5.2"
"West Virginia","1995","507859","30050","19627","3.8","24.8","4161","11.5","3257","9.0","36575","2163","2166","11015","29326","53046","82372","16.2","5.8","38509","62745","24236","12.4","4.8"
"Wisconsin","1995","2111438","97668","76195","3.6","20.4","12225","10.4","9979","8.5","118674","6766","6876","39606","93956","198418","292374","13.8","4.4","145888","216179","70291","10.2","3.3"
"Wyoming","1995","150101","12678","4766","3.1","28.8","1802","12.4","1400","9.6","14691","955","956","4198","10259","16076","26335","17.5","6.8","13682","21569","7887","14.4","5.3"
"Alabama","1996","1517840","70247","23546","1.5","28.4","10721","12.4","8773","10.1","87659","6118","6118","37078","89766","148711","238477","15.7","5.9","142799","214931","72132","14.2","4.8"
"Alaska","1996","175631","12128","2932","1.6","31.2","1859","13.0","1522","10.7","14441","930","930","4441","9714","20558","30272","17.2","5.5","16471","27340","10869","15.6","6.2"
"Arizona","1996","1519275","72373","81689","5.4","28.2","13178","15.0","9998","11.4","89522","6651","6652","43090","115988","180551","296539","19.5","7.6","134880","214850","79970","14.1","5.3"
"Arkansas","1996","882467","45282","16790","1.9","26.0","6695","12.4","5674","10.5","54317","4006","4007","21723","47090","84657","131747","14.9","5.3","77648","114957","37309","13.0","4.2"
"California","1996","10867543","533916","171652","1.6","32.4","83444","12.8","73535","11.3","656141","48254","48266","308558","684629","1252449","1937078","17.8","6.3","1093867","1765426","671559","16.2","6.2"
"Colorado","1996","1548413","88173","49972","3.2","33.0","15075","14.6","11757","11.4","104559","7651","7652","44769","129590","176133","305723","19.7","8.4","152575","255751","103176","16.5","6.7"
"Connecticut","1996","1403573","69027","17258","1.3","26.6","8146","10.0","7614","9.4","81409","4852","4853","28897","81487","122976","204463","14.6","5.8","125981","187205","61224","13.3","4.4"
"Delaware","1996","323605","15567","303","0.1","29.6","2211","12.1","1854","10.1","18533","1118","1118","6933","18331","30013","48344","14.9","5.7","30941","48041","17100","14.8","5.3"
"District of Columbia","1996","397889","14897","-18771","-4.8","24.4","1844","10.3","1689","9.5","17886","944","944","5785","16730","31983","48713","12.2","4.2","50678","67484","16806","17.0","4.2"
"Florida","1996","5192648","288960","149832","2.9","33.6","49338","14.1","42164","12.1","352893","29226","29228","186712","423981","600378","1024359","19.7","8.2","533598","874527","340929","16.8","6.6"
"Geogia","1996","2903831","128308","89297","3.0","30.8","22432","14.1","17505","11.0","161583","11270","11271","76178","209521","325793","535314","18.4","7.2","271083","446017","174934","15.4","6.0"
"Hawaii","1996","422490","21499","-1378","-0.3","28.8","2801","10.3","2835","10.5","27072","1776","1776","9072","27470","33461","60931","14.4","6.5","41744","62309","20565","14.7","4.9"
"Idaho","1996","373127","24803","11440","3.1","31.4","4159","14.6","3086","10.8","29029","2126","2126","12482","27110","42944","70054","18.8","7.3","36708","58614","21906","15.7","5.9"
"Illinois","1996","4902424","215915","58430","1.1","27.4","28857","11.0","25080","9.6","263187","15940","15941","93439","262148","465697","727845","14.8","5.3","462873","669415","206542","13.7","4.2"
"Indiana","1996","2376361","102077","10006","0.4","28.2","14091","11.0","12293","9.6","128389","7964","7965","48956","128150","217351","345501","14.5","5.4","217864","335495","117631","14.1","5.0"
"Iowa","1996","1124169","57677","28782","2.5","22.8","6862","9.7","6092","8.6","71152","4022","4023","20974","56230","100426","156656","13.9","5.0","87028","127874","40846","11.4","3.6"
"Kansas","1996","972447","52766","29591","3.0","25.2","7189","11.3","6071","9.5","64136","4163","4163","24401","57232","94785","152017","15.6","5.9","77533","122426","44893","12.6","4.6"
"Kentucky","1996","1335854","62919","19001","1.4","28.0","8805","11.4","7522","9.7","77957","5145","5145","31797","83980","121759","205739","15.4","6.3","125458","186738","61280","14.0","4.6"
"Louisiana","1996","1407156","71286","40074","2.8","27.6","9777","11.2","7860","9.0","88202","5338","5339","33637","80314","153351","233665","16.6","5.7","130605","193591","62986","13.8","4.5"
"Maine","1996","423512","26748","3752","0.8","26.2","3807","12.3","3033","9.8","31348","2123","2123","10892","22973","36101","59074","13.9","5.4","36448","55322","18874","13.1","4.5"
"Maryland","1996","1801753","88572","4604","0.2","31.0","12346","11.4","11091","10.3","108677","7007","7012","43985","108941","174636","283577","15.7","6.0","182801","278973","96172","15.5","5.3"
"Massachusetts","1996","2708174","119062","36892","1.3","26.4","15313","10.7","13184","9.2","143754","8329","8330","57694","129224","264650","393874","14.5","4.8","221496","356982","135486","13.2","5.0"
"Michigan","1996","3676047","164295","38599","1.0","26.8","22098","11.0","17827","8.9","203279","11828","11828","76617","182944","347334","530278","14.4","5.0","342533","491679","149146","13.4","4.1"
"Minnesota","1996","2070519","92887","40406","1.9","25.2","12516","11.3","9804","8.8","112583","6267","6269","41788","109205","191681","300886","14.5","5.3","181526","260480","78954","12.6","3.8"
"Mississippi","1996","853164","42269","10161","1.2","29.2","6295","12.2","5359","10.4","51929","3705","3705","22072","56494","78117","134611","15.8","6.6","79631","124450","44819","14.6","5.3"
"Missouri","1996","2158053","103215","39191","1.9","27.2","14497","11.5","12457","9.9","126733","8556","8556","48704","122184","211430","333614","15.5","5.7","194741","294423","99682","13.6","4.6"
"Montana","1996","258988","22079","5453","2.1","28.6","3290","13.1","2689","10.7","25378","1746","1746","8261","17483","24935","42418","16.4","6.8","22675","36965","14290","14.3","5.5"
"Nebraska","1996","671920","35321","21279","3.1","22.8","4267","10.1","3840","9.1","42573","2617","2617","13617","35437","62127","97564","14.5","5.3","51307","76285","24978","11.4","3.7"
"Nevada","1996","683539","27947","41732","6.2","30.0","5563","17.1","4067","12.5","33304","2720","2720","20800","65304","79290","144594","21.2","9.6","61429","102862","41433","15.0","6.1"
"New Hampshire","1996","468910","26469","17917","3.9","24.2","3888","12.7","2977","9.7","31128","1939","1940","10861","26268","48614","74882","16.0","5.6","36939","56965","20026","12.1","4.3"
"New Jersey","1996","3151479","167550","22991","0.7","30.0","22753","11.7","19861","10.3","194970","13287","13290","71341","182341","312443","494784","15.7","5.8","308336","471793","163457","15.0","5.2"
"New Mexico","1996","498067","30569","13332","2.7","30.2","4822","13.3","3798","10.5","36595","2599","2601","15775","34869","53847","88716","17.8","7.0","48172","75384","27212","15.1","5.5"
"New York","1996","6672472","353159","26558","0.4","28.8","47794","11.6","43931","10.7","412331","30626","30629","175177","373628","612938","986566","14.8","5.6","628318","960008","331690","14.4","5.0"
"North Carolina","1996","2975330","132391","50488","1.7","27.0","20353","12.4","15587","9.5","166207","10141","10141","62086","171783","280532","452315","15.2","5.8","267280","401827","134547","13.5","4.5"
"North Dakota","1996","230009","15398","4539","2.0","26.0","1714","9.5","1511","8.4","18162","998","998","4929","13684","20856","34540","15.0","5.9","20403","30001","9598","13.0","4.2"
"Ohio","1996","4536693","187279","81492","1.8","26.0","24297","10.2","21523","9.0","239476","13662","13665","83410","241266","428284","669550","14.8","5.3","400188","588058","187870","13.0","4.1"
"Oklahoma","1996","1041769","60598","35956","3.5","27.0","8700","11.9","7551","10.4","73469","5280","5283","28641","73473","103488","176961","17.0","7.1","88802","141005","52203","13.5","5.0"
"Oregon","1996","1189725","70104","54580","4.6","27.0","11229","13.6","8675","10.5","83597","5877","5879","32452","79393","135442","214835","18.1","6.7","103916","160255","56339","13.5","4.7"
"Pennsylvania","1996","4664500","207805","37551","0.8","25.6","24959","9.7","22908","8.9","258795","15088","15090","98212","233472","399887","633359","13.6","5.0","390192","595808","205616","12.8","4.4"
"Rhode Island","1996","377494","21725","1001","0.3","26.4","2687","11.0","2426","10.0","24464","1662","1664","9645","19028","31835","50863","13.5","5.0","31416","49862","18446","13.2","4.9"
"South Carolina","1996","1383948","64103","28158","2.1","27.2","10219","12.9","8056","10.2","80130","5429","5429","32535","87719","128894","216613","15.7","6.3","125836","188455","62619","13.6","4.5"
"South Dakota","1996","266747","17448","3831","1.4","25.2","2219","11.0","1888","9.4","20283","1289","1289","6352","15242","22214","37456","14.0","5.7","21314","33625","12311","12.6","4.6"
"Tennessee","1996","2143582","90434","9761","0.5","29.8","14090","12.5","11358","10.0","114345","7659","7663","69872","133125","196366","329491","15.4","6.2","196857","319730","122873","14.9","5.7"
"Texas","1996","6713351","310610","220988","3.3","30.8","52207","13.3","43281","11.0","397019","28625","28628","186478","499314","752897","1252211","18.7","7.4","653692","1031223","377531","15.4","5.6"
"Utah","1996","751213","34162","38411","5.1","27.0","6375","15.9","4355","10.9","41069","2992","2993","19996","58049","81901","139950","18.6","7.7","66319","101539","35220","13.5","4.7"
"Vermont","1996","222244","16040","1200","0.5","28.2","1953","10.8","1698","9.4","18169","1214","1214","6718","12615","19923","32538","14.6","5.7","16391","31338","14947","14.1","6.7"
"Virginia","1996","2449973","115604","31518","1.3","29.0","17268","11.9","14830","10.2","146732","9331","9331","50222","145866","240627","386493","15.8","6.0","235516","354975","119459","14.5","4.9"
"Washington","1996","1931829","112031","32866","1.7","29.6","18622","14.0","15532","11.7","134360","10195","10198","55214","125297","192651","317948","16.5","6.5","187293","285082","97789","14.8","5.1"
"West Virginia","1996","519318","30217","639","0.2","29.2","3968","10.8","3532","9.6","36895","2367","2367","11766","31649","45044","76693","14.8","6.1","51129","76054","24925","14.6","4.8"
"Wisconsin","1996","2168526","98939","31893","1.4","22.8","12227","10.2","10486","8.8","120286","6943","6949","38286","96140","182206","278346","12.8","4.4","166572","246453","79881","11.4","3.7"
"Wyoming","1996","151556","13002","-1465","-0.9","31.0","1891","12.7","1511","10.2","15027","1015","1015","4342","9267","14171","23438","15.5","6.1","17245","24903","7658","16.4","5.1"
"Alabama","1997","1537043","71119","14222","0.9","32.2","11391","12.8","9689","10.9","89421","6363","6363","41788","99693","161737","261430","17.0","6.5","158811","247208","88397","16.1","5.8"
"Alaska","1997","179388","12384","5469","3.1","34.6","1988","13.6","1610","11.0","14784","970","970","4416","12230","24310","36540","20.4","6.8","21368","31071","9703","17.3","5.4"
"Arizona","1997","1608847","74812","91739","5.7","34.6","14962","16.3","11406","12.5","93249","7065","7065","47498","151056","219607","370663","23.0","9.4","160545","278924","118379","17.3","7.4"
"Arkansas","1997","896806","45623","19775","2.3","28.6","7014","12.8","6040","11.0","55154","4092","4092","22299","55590","92835","148425","16.6","6.2","84429","128650","44221","14.3","4.9"
"California","1997","11151803","541289","362159","3.3","34.2","90208","13.6","81035","12.3","665108","48557","48558","342815","822432","1451680","2274112","20.4","7.4","1158681","1911953","753272","17.1","6.8"
"Colorado","1997","1601950","90837","56591","3.5","35.0","16708","15.7","12753","12.0","108371","7956","7956","50503","142429","194070","336499","21.0","8.9","166611","279908","113297","17.5","7.1"
"Connecticut","1997","1445493","69113","42797","3.0","28.2","8854","10.8","8331","10.2","81941","5019","5019","32797","82514","164359","246873","17.1","5.7","127675","204076","76401","14.1","5.3"
"Delaware","1997","330868","15973","14304","4.3","29.0","2598","13.8","2020","10.7","19154","1159","1159","7407","24659","37609","62268","18.8","7.5","29169","47964","18795","14.5","5.7"
"District of Columbia","1997","389370","14857","975","0.3","28.6","1933","10.8","2035","11.4","17806","1014","1014","6393","18692","38139","56831","14.6","4.8","33946","55856","21910","14.3","5.6"
"Florida","1997","5343300","292387","142245","2.7","36.6","53317","14.9","46047","12.9","359980","30462","30463","199698","468512","653941","1122453","21.0","8.8","575103","980208","405105","18.3","7.6"
"Geogia","1997","2983982","131028","71242","2.4","34.4","23700","14.4","19063","11.6","166115","11964","11964","97130","228088","357229","585317","19.6","7.6","314080","514075","199995","17.2","6.7"
"Hawaii","1997","421474","21466","-682","-0.2","28.6","2915","10.8","2937","10.9","27009","1762","1762","9598","20657","39794","60451","14.3","4.9","40728","61133","20405","14.5","4.8"
"Idaho","1997","383919","25575","8882","2.3","33.8","4554","15.4","3562","12.0","30023","2260","2260","11277","29531","44050","73581","19.2","7.7","38382","64699","26317","16.9","6.9"
"Illinois","1997","4978069","217733","88450","1.7","29.0","30750","11.6","27510","10.4","266291","16572","16572","112741","283940","524668","808608","16.2","5.7","458481","720158","261677","14.5","5.3"
"Indiana","1997","2408409","102793","48240","2.0","28.4","15338","11.8","13301","10.3","130432","8274","8274","54427","135231","254598","389829","16.2","5.6","213913","341589","127676","14.2","5.3"
"Iowa","1997","1146531","57954","12456","1.1","28.0","7461","10.4","6709","9.4","71920","4155","4155","26799","59467","113445","172912","15.1","5.2","102506","160456","57950","14.0","5.1"
"Kansas","1997","1005385","53327","35903","3.6","27.6","7971","12.3","6794","10.5","65272","4203","4203","24367","68479","106050","174529","17.4","6.8","89182","138626","49444","13.8","4.9"
"Kentucky","1997","1366187","63608","40969","3.0","28.8","9655","12.3","8237","10.5","79348","5161","5161","32270","85042","152875","237917","17.4","6.2","124176","196948","72772","14.4","5.3"
"Louisiana","1997","1445436","72192","31627","2.1","32.2","10564","11.9","9124","10.2","89720","5749","5749","36611","93628","170068","263696","18.2","6.5","143525","232069","88544","16.1","6.1"
"Maine","1997","430596","27204","9354","2.2","26.8","3947","12.4","3290","10.4","32013","2075","2075","11602","23415","43731","67146","15.6","5.4","35254","57792","22538","13.4","5.2"
"Maryland","1997","1837782","89546","64079","3.5","31.4","13880","12.7","12344","11.3","110313","7307","7307","43634","132636","219362","351998","19.2","7.2","180215","287919","107704","15.7","5.9"
"Massachusetts","1997","2767461","121311","76552","2.8","28.0","16984","11.7","13728","9.4","147093","8285","8285","59442","168258","296970","465228","16.8","6.1","252446","388676","136230","14.0","4.9"
"Michigan","1997","3743274","166302","89690","2.4","29.4","23454","11.5","20710","10.1","205977","12533","12533","80058","217907","421623","639530","17.1","5.8","356911","549840","192929","14.7","5.2"
"Minnesota","1997","2119083","94571","49559","2.4","27.8","13881","12.2","11250","9.9","115237","6750","6750","47812","119717","225056","344773","16.3","5.6","181141","295214","114073","13.9","5.4"
"Mississippi","1997","871930","42810","21801","2.5","29.6","6596","12.6","5618","10.7","52944","3723","3723","20389","53339","97939","151278","17.3","6.1","85594","129477","43883","14.8","5.0"
"Missouri","1997","2210438","103505","61237","2.7","28.2","15038","11.8","14111","11.1","127642","9120","9120","55995","127305","244724","372029","16.8","5.8","196306","310792","114486","14.1","5.2"
"Montana","1997","264252","22631","3933","1.4","33.0","3473","13.5","2783","10.8","26050","1848","1848","9171","18308","29107","47415","17.9","6.9","26879","43482","16603","16.5","6.3"
"Nebraska","1997","686399","35809","5907","0.9","29.4","4730","11.0","4103","9.6","43191","2551","2551","16260","41841","64937","106778","15.6","6.1","68110","100871","32761","14.7","4.8"
"Nevada","1997","727932","29497","45161","6.2","31.0","6636","19.2","4488","13.0","35507","2816","2816","18118","68348","89672","158020","21.7","9.4","73427","112859","39432","15.5","5.4"
"New Hampshire","1997","483945","26990","10941","2.2","28.6","3979","12.6","3306","10.5","31813","2070","2070","11713","28118","51962","80080","16.5","5.8","43922","69139","25217","14.3","5.2"
"New Jersey","1997","3211284","170254","94613","3.0","31.6","25247","12.8","21738","11.0","198247","13559","13559","80352","212380","389882","602262","18.8","6.6","307646","507649","200003","15.8","6.2"
"New Mexico","1997","509114","30759","7346","1.5","34.4","5071","13.7","4446","12.0","37189","2831","2831","14972","37901","57133","95034","18.7","7.4","57439","87688","30249","17.2","5.9"
"New York","1997","6749099","356925","106564","1.5","30.4","51095","12.3","46098","11.1","417265","30732","30732","177608","387219","743254","1130473","16.7","5.7","630363","1023909","393546","15.2","5.8"
"North Carolina","1997","3052055","136584","97504","3.2","28.0","24068","14.2","17075","10.0","173190","10575","10575","66103","203133","320757","523890","17.2","6.7","270116","426386","156270","14.0","5.1"
"North Dakota","1997","237454","15261","10408","4.4","27.2","1770","9.8","1840","10.2","18067","1160","1160","7735","13866","28843","42709","18.0","5.8","18722","32301","13579","13.6","5.7"
"Ohio","1997","4616927","188525","73685","1.6","29.4","26985","11.2","24451","10.1","242011","14410","14410","95574","284352","468340","752692","16.3","6.2","440418","679007","238589","14.7","5.2"
"Oklahoma","1997","1077618","61285","36391","3.3","31.2","9811","13.2","8300","11.2","74941","5432","5432","33877","79651","124475","204126","18.9","7.4","108047","167735","59688","15.6","5.5"
"Oregon","1997","1246464","71390","56868","4.6","30.4","11683","13.8","9680","11.4","85533","6118","6118","33245","88290","158197","246487","19.8","7.1","117800","189619","71819","15.2","5.8"
"Pennsylvania","1997","4730865","209371","75923","1.6","28.2","28280","10.8","24940","9.6","262288","15063","15063","110568","257317","484111","741428","15.7","5.4","418234","665505","247271","14.1","5.2"
"Rhode Island","1997","383505","21985","10248","2.6","26.4","2736","11.1","2452","10.0","24753","1663","1663","8942","22004","38727","60731","15.8","5.7","32573","50483","17910","13.2","4.7"
"South Carolina","1997","1418402","65651","37702","2.6","29.6","11173","13.7","8773","10.8","82583","5520","5520","36310","97943","149114","247057","17.4","6.9","131568","209355","77787","14.8","5.5"
"South Dakota","1997","272405","17561","7448","2.7","27.6","2438","11.9","2123","10.4","20549","1352","1352","6873","18240","26670","44910","16.5","6.7","23171","37462","14291","13.8","5.2"
"Tennessee","1997","2179189","91591","56161","2.6","30.6","15087","13.0","12678","10.9","116886","8032","8032","54704","149410","239893","389303","17.9","6.9","216238","333142","116904","15.3","5.4"
"Texas","1997","6966375","314689","261324","3.7","34.2","55983","13.9","47888","11.9","405103","29979","29979","220929","568149","882594","1450743","20.8","8.2","720393","1189419","469026","17.1","6.7"
"Utah","1997","793332","35629","40862","5.1","31.8","6948","16.5","4980","11.8","43022","3170","3170","22166","70363","96484","166847","21.0","8.9","72552","125985","53433","15.9","6.7"
"Vermont","1997","226081","16269","6103","2.7","26.6","2117","11.5","1805","9.8","18497","1216","1216","5982","16081","20099","36180","16.0","7.1","18528","30077","11549","13.3","5.1"
"Virginia","1997","2522571","118049","110281","4.4","29.0","19450","13.1","15724","10.6","150435","9262","9262","55667","177066","299428","476494","18.9","7.0","232038","366213","134175","14.5","5.3"
"Washington","1997","1975920","113960","47569","2.4","35.2","19859","14.6","16914","12.4","137179","10332","10333","59617","149567","246048","395615","20.0","7.6","193429","348046","154617","17.6","7.8"
"West Virginia","1997","524833","30407","10441","2.0","28.4","4245","11.4","3731","10.0","37396","2378","2378","12760","31147","53951","85098","16.2","5.9","50617","74657","24040","14.2","4.6"
"Wisconsin","1997","2210322","100150","47149","2.2","25.4","13451","11.1","11304","9.3","122451","7013","7013","40403","119807","208866","328673","14.9","5.4","184060","281524","97464","12.7","4.4"
"Wyoming","1997","151861","13159","3057","2.0","34.0","1920","12.7","1809","12.0","15076","1049","1049","4954","10729","18151","28880","19.0","7.1","15765","25823","10058","17.0","6.6"
"Alabama","1998","1554924","71184","18680","1.2","29.4","10431","11.6","9870","11.0","89772","6666","6666","38934","89511","158280","247791","15.9","5.8","136108","229111","93003","14.7","6.0"
"Alaska","1998","186202","12574","8298","4.4","30.2","1987","13.3","1675","11.2","15009","1032","1032","4616","13872","22494","36366","19.5","7.4","18632","28068","9436","15.1","5.1"
"Arizona","1998","1690810","75861","72057","4.3","32.0","13306","14.2","11412","12.1","94828","7528","7528","65412","132954","210402","343356","20.3","7.9","157779","271299","113520","16.0","6.7"
"Arkansas","1998","922751","45392","21515","2.3","27.4","6505","11.8","6327","11.5","55295","4400","4400","23580","59576","88234","147810","16.0","6.5","75150","126295","51145","13.7","5.5"
"California","1998","11551112","547613","523671","4.6","30.0","87132","13.0","76362","11.4","673732","49757","49757","331103","830664","1428229","2258893","19.6","7.2","1057460","1735222","677762","15.0","5.9"
"Colorado","1998","1675464","92986","89921","5.4","29.8","16134","14.7","12711","11.6","111498","8438","8438","48996","133185","206251","339436","20.3","7.9","153522","249515","95993","14.9","5.7"
"Connecticut","1998","1474336","69005","18961","1.3","28.6","8390","10.2","8255","10.1","81916","5284","5284","32961","88146","141531","229677","15.6","6.0","138216","210716","72500","14.3","4.9"
"Delaware","1998","342454","16294","9412","2.7","30.6","2476","12.8","2064","10.7","19518","1244","1244","8032","25315","36351","61666","18.0","7.4","34794","52254","17460","15.3","5.1"
"District of Columbia","1998","395209","14773","8741","2.2","25.0","1789","10.1","1752","9.8","17793","968","968","6749","18996","39210","58206","14.7","4.8","33774","49465","15691","12.5","4.0"
"Florida","1998","5517662","294299","222821","4.1","32.2","49783","13.8","46200","12.8","362462","30924","30924","193097","425701","687943","1113644","20.2","7.7","515659","890823","375164","16.1","6.8"
"Geogia","1998","3068552","133252","91879","3.0","31.6","23294","13.9","19507","11.6","169415","12413","12413","86293","228036","349875","577911","18.8","7.4","291726","486032","194306","15.8","6.3"
"Hawaii","1998","418240","21380","-5554","-1.3","27.8","2692","10.0","2864","10.6","26808","1795","1795","9526","23996","34041","58037","13.9","5.7","38952","63591","24639","15.2","5.9"
"Idaho","1998","398919","26008","21043","5.2","29.4","4217","13.9","3537","11.7","30632","2376","2376","11790","34475","45026","79501","19.9","8.6","37708","58458","20750","14.7","5.2"
"Illinois","1998","5089815","219245","139376","2.8","26.0","28657","10.7","25421","9.5","269011","16454","16454","110528","269736","533319","803055","15.8","5.3","436180","663679","227499","13.0","4.5"
"Indiana","1998","2462442","103255","60547","2.5","25.2","13798","10.5","12574","9.6","131429","8262","8262","51150","136428","235317","371745","15.1","5.5","200286","311198","110912","12.6","4.5"
"Iowa","1998","1171738","58097","40454","3.5","22.2","6936","9.6","6340","8.8","72351","4134","4134","22128","55767","114738","170505","14.6","4.8","86207","130051","43844","11.1","3.7"
"Kansas","1998","1040239","53594","34362","3.3","27.0","7349","11.2","6598","10.1","65851","4382","4382","26275","65754","109229","174983","16.8","6.3","83873","140621","56748","13.5","5.5"
"Kentucky","1998","1401123","64136","33337","2.4","27.6","9195","11.5","8019","10.0","80353","5302","5302","31200","91628","135752","227380","16.2","6.5","127603","194043","66440","13.8","4.7"
"Louisiana","1998","1486718","72602","48734","3.3","29.2","10014","11.1","9012","10.0","90443","5922","5922","42913","95349","170683","266032","17.9","6.4","135918","217298","81380","14.6","5.5"
"Maine","1998","442486","27757","14959","3.4","23.6","3939","12.2","3180","9.8","32679","2176","2176","11816","25821","41342","67163","15.2","5.8","31991","52204","20213","11.8","4.6"
"Maryland","1998","1899176","89974","45922","2.4","29.6","12765","11.5","11921","10.8","110917","7393","7393","50711","126236","199918","326154","17.2","6.6","170620","280232","109612","14.8","5.8"
"Massachusetts","1998","2835988","122544","64781","2.3","27.2","15650","10.6","13772","9.3","148564","8862","8862","58658","150811","299093","449904","15.9","5.3","257949","385123","127174","13.6","4.5"
"Michigan","1998","3828325","166559","94912","2.4","26.4","21766","10.5","20270","9.8","206886","13239","13239","85747","213553","384860","598413","15.6","5.6","329906","503501","173595","13.2","4.5"
"Minnesota","1998","2188697","96430","94852","4.4","24.6","12907","11.1","10414","9.0","117421","6719","6719","47498","121108","243493","364601","16.7","5.5","178767","269749","90982","12.3","4.2"
"Mississippi","1998","892900","42886","23546","2.6","25.8","6171","11.6","5662","10.7","53305","3917","3917","23430","49299","89143","138442","15.5","5.5","71305","114896","43591","12.9","4.9"
"Missouri","1998","2254889","103817","33161","1.5","26.8","14381","11.2","13298","10.4","128458","8883","8883","49293","130708","205530","336238","14.9","5.8","202754","303077","100323","13.4","4.4"
"Montana","1998","268743","23024","6706","2.5","30.0","3486","13.3","2913","11.1","26521","2008","2008","8423","19901","27076","46977","17.5","7.4","23420","40271","16851","15.0","6.3"
"Nebraska","1998","696092","35905","17593","2.6","24.4","4414","10.2","4016","9.3","43466","2686","2686","14163","37276","65434","102710","14.8","5.4","53970","85117","31147","12.2","4.5"
"Nevada","1998","764278","30787","31266","4.1","29.2","6385","17.5","4489","12.3","37285","3007","3007","19472","61515","81555","143070","18.7","8.0","74394","111804","37410","14.6","4.9"
"New Hampshire","1998","498116","27495","18441","3.7","25.6","3713","11.6","3157","9.9","32267","2052","2052","13096","27523","54858","82381","16.5","5.5","39223","63940","24717","12.8","5.0"
"New Jersey","1998","3295447","172256","73313","2.2","30.4","23810","11.9","20852","10.5","200653","13932","13932","81505","210852","362286","573138","17.4","6.4","314973","499825","184852","15.2","5.6"
"New Mexico","1998","515866","30913","10996","2.1","31.8","4630","12.4","4259","11.4","37432","2760","2760","16871","40376","52605","92981","18.0","7.8","48818","81985","33167","15.9","6.4"
"New York","1998","6874662","360277","155236","2.2","29.2","48687","11.6","43666","10.4","421540","30537","30537","173389","393513","764792","1158305","16.8","5.7","655456","1003069","347613","14.6","5.1"
"North Carolina","1998","3142561","139048","87604","2.8","27.0","22052","12.6","18873","10.8","175959","11661","11664","69864","203990","308825","512815","16.3","6.5","255722","425211","169489","13.5","5.4"
"North Dakota","1998","243173","15285","1628","0.7","29.8","1729","9.6","1672","9.2","18087","1089","1089","6932","13698","24152","37850","15.6","5.6","23384","36222","12838","14.9","5.3"
"Ohio","1998","4700175","189006","102394","2.2","26.2","24019","9.9","22509","9.3","243121","14180","14181","96181","237168","482588","719756","15.3","5.0","391760","617362","225602","13.1","4.8"
"Oklahoma","1998","1116702","61526","44366","3.9","27.4","8838","11.8","8140","10.8","75425","5493","5495","31861","72780","124029","196809","17.6","6.5","90881","152443","61562","13.7","5.5"
"Oregon","1998","1282318","72173","18842","1.5","30.6","10813","12.6","9636","11.2","86408","6227","6227","36199","81653","133865","215518","16.8","6.4","123253","196676","73423","15.3","5.7"
"Pennsylvania","1998","4813369","210232","88571","1.8","25.6","25903","9.8","23701","9.0","263993","15122","15122","96346","243869","459677","703546","14.6","5.1","399652","614975","215323","12.8","4.5"
"Rhode Island","1998","394558","22163","11234","2.8","24.8","2612","10.5","2413","9.7","24910","1647","1647","8192","21656","38483","60139","15.2","5.5","32892","48905","16013","12.4","4.1"
"South Carolina","1998","1464809","66821","55932","3.8","27.6","10586","12.7","8908","10.7","84107","5845","5845","34496","105149","152210","257359","17.6","7.2","121500","201427","79927","13.8","5.5"
"South Dakota","1998","280509","17648","10501","3.7","23.4","2257","11.0","2068","10.0","20654","1418","1418","7088","14737","28566","43303","15.4","5.3","20023","32802","12779","11.7","4.6"
"Tennessee","1998","2239565","91610","67881","3.0","27.2","13943","11.9","12658","10.8","117770","8397","8398","54404","146707","225499","372206","16.6","6.6","193092","304325","111233","13.6","5.0"
"Texas","1998","7246952","317825","300265","4.1","31.2","52894","13.0","46290","11.4","410599","29933","29937","216355","546107","884756","1430863","19.7","7.5","702429","1130598","428169","15.6","5.9"
"Utah","1998","824763","36535","24593","3.0","33.2","6550","15.0","5175","11.9","44197","3433","3433","23593","67591","93926","161517","19.6","8.2","91942","136924","44982","16.6","5.5"
"Vermont","1998","233354","16311","7107","3.1","23.8","1914","10.4","1887","10.2","18481","1284","1284","5674","11993","22978","34971","15.0","5.1","17192","27864","10672","11.9","4.6"
"Virginia","1998","2610099","119595","65603","2.6","28.2","18526","12.2","15638","10.3","152958","9646","9646","59450","168817","265849","434666","16.7","6.5","229030","369063","140033","14.1","5.4"
"Washington","1998","2034268","115841","75319","3.7","28.8","18713","13.5","15809","11.4","139701","10440","10440","55971","131928","236521","368449","18.1","6.5","185027","293130","108103","14.4","5.3"
"West Virginia","1998","534253","30398","6203","1.2","27.8","3779","10.1","3571","9.5","37532","2407","2407","12495","30728","49841","80569","15.1","5.8","49851","74366","24515","13.9","4.6"
"Wisconsin","1998","2263122","100895","59124","2.6","23.0","12185","9.9","10871","8.8","123469","7171","7171","42406","109426","210463","319889","14.1","4.8","172484","260765","88281","11.5","3.9"
"Wyoming","1998","155229","13389","2850","1.9","33.0","1931","12.7","1615","10.6","15391","1073","1073","5824","12203","16314","28517","18.4","7.9","14880","25667","10787","16.5","6.9"
"Alabama","1999","1592218","71205","29061","1.8","29.0","10252","11.4","9540","10.6","90344","6393","6393","39765","107222","152194","259416","16.3","6.7","146048","230355","84307","14.5","5.3"
"Alaska","1999","192105","12622","1227","0.7","30.2","1780","11.8","1616","10.7","15134","1026","1026","4472","10726","19570","30296","15.8","5.6","19800","29069","9269","15.1","4.8"
"Arizona","1999","1764631","77311","75492","4.3","32.2","14051","14.6","11555","12.0","97254","7293","7293","56325","149166","210290","359456","20.4","8.5","169875","283964","114089","16.1","6.5"
"Arkansas","1999","942752","45341","12824","1.4","28.2","6495","11.7","6159","11.1","55562","4172","4172","23722","53021","93175","146196","15.5","5.6","80909","133372","52463","14.1","5.6"
"California","1999","11990313","554863","293163","2.4","32.4","87519","12.9","76825","11.3","683714","48337","48337","340217","847713","1387381","2235094","18.6","7.1","1185775","1941931","756156","16.2","6.3"
"Colorado","1999","1759199","95003","67257","3.8","32.0","16109","14.3","12971","11.5","114449","8335","8335","50944","143998","204585","348583","19.8","8.2","165352","281326","115974","16.0","6.6"
"Connecticut","1999","1499805","68663","32365","2.1","26.2","8038","9.8","7811","9.5","82063","5050","5050","30806","80295","148387","228682","15.2","5.4","123061","196317","73256","13.1","4.9"
"Delaware","1999","348206","16662","2042","0.6","30.0","2489","12.6","2050","10.4","19938","1182","1182","7526","22718","31639","54357","15.6","6.5","33731","52315","18584","15.0","5.3"
"District of Columbia","1999","403311","14733","6820","1.7","26.2","1800","10.1","1756","9.9","17835","933","933","6353","21680","37867","59547","14.8","5.4","32621","52727","20106","13.1","5.0"
"Florida","1999","5742642","296539","221866","3.8","34.4","51234","14.0","45649","12.5","367234","30396","30396","193480","436562","771132","1207694","21.0","7.6","556381","985828","429447","17.2","7.5"
"Geogia","1999","3214638","135585","164862","5.1","29.2","22852","13.4","19306","11.3","172753","12198","12198","82646","249748","384013","633761","19.7","7.8","279479","468899","189420","14.6","5.9"
"Hawaii","1999","415078","21205","475","0.1","28.4","2545","9.5","2696","10.1","26591","1695","1695","10249","25382","33866","59248","14.3","6.1","37601","58773","21172","14.2","5.1"
"Idaho","1999","422144","26590","13972","3.3","28.2","4363","14.0","3346","10.7","31613","2254","2254","12893","30248","43086","73334","17.4","7.2","35293","59362","24069","14.1","5.7"
"Illinois","1999","5212988","219961","111964","2.1","26.0","27980","10.4","25848","9.6","271020","16158","16158","98406","275854","512388","788242","15.1","5.3","437828","676278","238450","13.0","4.6"
"Indiana","1999","2532484","103095","46487","1.8","25.6","13249","10.1","12534","9.5","132072","8237","8237","54103","126738","242865","369603","14.6","5.0","213089","323116","110027","12.8","4.3"
"Iowa","1999","1214396","57954","26712","2.2","24.2","6713","9.3","6387","8.8","72615","4219","4219","22359","63199","109915","173114","14.3","5.2","96473","146402","49929","12.1","4.1"
"Kansas","1999","1079168","53670","31449","2.9","27.2","7020","10.6","6652","10.1","66226","4280","4280","26864","67247","110963","178210","16.5","6.2","86907","146761","59854","13.6","5.5"
"Kentucky","1999","1429750","64218","16670","1.1","28.0","8762","10.9","8051","10.0","80979","5350","5350","31284","85017","131393","216410","15.1","5.9","130736","199740","69004","14.0","4.8"
"Louisiana","1999","1544149","72517","8056","0.5","30.8","9509","10.5","9032","10.0","90939","5897","5897","45762","88905","156234","245139","15.9","5.8","146984","237083","90099","15.4","5.8"
"Maine","1999","458062","28318","13802","3.0","24.8","3879","11.7","3154","9.5","33386","2080","2080","11386","25691","44964","70655","15.4","5.6","37354","56853","19499","12.4","4.3"
"Maryland","1999","1937473","90551","27688","1.4","31.2","12499","11.2","11412","10.2","111811","6943","6943","56037","125198","204580","329778","17.0","6.5","179533","302090","122557","15.6","6.3"
"Massachusetts","1999","2905949","123189","68634","2.3","27.6","15144","10.2","13970","9.4","149587","8808","8808","60529","168681","300248","468929","16.1","5.8","258581","400295","141714","13.8","4.9"
"Michigan","1999","3915129","166542","57912","1.5","28.0","21016","10.1","19718","9.5","208019","12782","12782","88597","226804","380920","607724","15.5","5.8","365677","549812","184135","14.0","4.7"
"Minnesota","1999","2280605","97772","63467","2.8","25.2","12920","10.9","10751","9.1","119533","6612","6612","42182","134263","216286","350549","15.4","5.9","180709","287082","106373","12.6","4.7"
"Mississippi","1999","931169","42998","17264","1.9","27.4","6159","11.5","5731","10.7","53712","3933","3933","23661","51988","93214","145202","15.6","5.6","78821","127938","49117","13.7","5.3"
"Missouri","1999","2303360","103901","51331","2.2","26.8","14192","11.0","13269","10.3","129299","8803","8803","46197","132178","227370","359548","15.6","5.7","194106","308217","114111","13.4","5.0"
"Montana","1999","277953","23241","10897","3.9","27.2","3208","12.0","2825","10.6","26848","1916","1916","8314","18611","29973","48584","17.5","6.7","22796","37687","14891","13.6","5.4"
"Nebraska","1999","718369","36010","21020","3.0","25.4","4205","9.6","3961","9.1","43713","2582","2582","19709","43096","69435","112531","15.7","6.0","55191","91511","36320","12.7","5.1"
"Nevada","1999","813262","32240","56919","7.0","28.6","6935","18.1","4704","12.3","39498","3081","3081","22686","76118","97184","173302","21.3","9.4","73476","116383","42907","14.3","5.3"
"New Hampshire","1999","514173","27757","14006","2.8","23.4","3544","10.9","3005","9.2","32782","2016","2016","10729","27158","47176","74334","14.5","5.3","40682","60328","19646","11.7","3.8"
"New Jersey","1999","3369725","172977","75832","2.2","28.8","22557","11.2","20848","10.4","202065","13880","13880","81840","213169","346243","559412","16.6","6.3","312477","483580","171103","14.4","5.1"
"New Mexico","1999","532112","30830","6023","1.2","31.4","4622","12.3","4290","11.4","37743","2794","2794","15035","38186","51614","89800","16.9","7.2","54065","83777","29712","15.7","5.6"
"New York","1999","7013892","361153","114358","1.6","27.6","47236","11.2","43322","10.2","424942","30114","30114","179703","400354","682833","1083187","15.4","5.7","612157","968829","356672","13.8","5.1"
"North Carolina","1999","3238145","141395","86063","2.7","28.8","21750","12.2","18065","10.2","179380","11522","11522","81747","214293","339345","553638","17.1","6.6","288499","467575","179076","14.4","5.5"
"North Dakota","1999","246400","15225","1239","0.5","25.6","1530","8.5","1526","8.4","18087","1008","1008","5066","12767","19977","32744","13.3","5.2","20923","31505","10582","12.8","4.3"
"Ohio","1999","4785467","188850","53125","1.1","26.6","23293","9.6","21883","9.0","244231","13713","13713","88451","245007","445735","690742","14.4","5.1","416330","637617","221287","13.3","4.6"
"Oklahoma","1999","1150040","61424","9710","0.8","32.2","8733","11.6","8302","11.0","75635","5431","5431","32643","75665","118644","194309","16.9","6.6","114404","184599","70195","16.1","6.1"
"Oregon","1999","1300624","72476","18615","1.5","30.2","10709","12.3","9631","11.1","87338","6323","6323","35739","81491","133803","215294","16.6","6.3","117727","196679","78952","15.1","6.1"
"Pennsylvania","1999","4884235","210279","50894","1.0","26.2","25039","9.5","23901","9.0","264930","15129","15129","97338","242211","446295","688506","14.1","5.0","420574","637612","217038","13.1","4.4"
"Rhode Island","1999","401157","22068","3092","0.7","26.4","2521","10.1","2423","9.7","24983","1724","1724","8506","18030","37923","55953","13.9","4.5","34681","52861","18180","13.2","4.5"
"South Carolina","1999","1519624","68153","39880","2.7","27.4","10757","12.7","8885","10.5","85886","5701","5701","34117","95047","153470","248517","16.4","6.3","137798","208637","70839","13.7","4.7"
"South Dakota","1999","288703","17726","5599","2.0","24.4","2208","10.6","2010","9.7","20844","1362","1362","6365","16727","24186","40913","14.2","5.8","22299","35314","13015","12.2","4.5"
"Tennessee","1999","2294827","91282","25653","1.1","30.0","13494","11.4","12875","10.9","118281","8258","8258","51251","144145","224958","369103","16.1","6.3","212685","343450","130765","15.0","5.7"
"Texas","1999","7534968","318388","167023","2.2","33.8","52078","12.6","47181","11.4","415081","30473","30473","223962","560733","879583","1440316","19.1","7.4","764995","1273293","508298","16.9","6.7"
"Utah","1999","863060","37559","22976","2.7","30.6","7080","15.7","5307","11.8","45911","3525","3525","28090","64845","90210","155055","18.0","7.5","79114","132079","52965","15.3","6.1"
"Vermont","1999","240470","16411","6848","2.8","22.8","1904","10.2","1638","8.8","18748","1154","1154","6686","12401","21749","34150","14.2","5.2","17615","27302","9687","11.4","4.0"
"Virginia","1999","2698619","120352","80377","2.9","27.4","17561","11.4","15931","10.4","154389","9631","9631","55953","166222","283013","449235","16.6","6.2","234030","368858","134828","13.7","5.0"
"Washington","1999","2110334","116654","64718","3.1","29.8","18314","13.0","16507","11.8","141204","10666","10666","61026","152182","226804","378986","18.0","7.2","195110","314268","119158","14.9","5.6"
"West Virginia","1999","537918","30313","-2600","-0.5","27.0","3732","9.9","3739","10.0","37514","2414","2414","12191","28146","44648","72794","13.5","5.2","48472","75394","26922","14.0","5.0"
"Wisconsin","1999","2312929","101193","40619","1.8","23.8","11985","9.7","10896","8.8","124456","7139","7139","43716","104737","211326","316063","13.7","4.5","181804","275444","93640","11.9","4.0"
"Wyoming","1999","162778","13373","4869","3.0","30.6","1839","11.9","1733","11.2","15481","1162","1162","5243","10837","18979","29816","18.3","6.7","15060","24947","9887","15.3","6.1"
"Alabama","2000","1624678","70588","35523","2.2","27.6","9581","10.6","9904","11.0","90084","6308","6308","37525","85796","173985","259781","16.0","5.3","139121","224258","85137","13.8","5.2"
"Alaska","2000","197752","12622","9158","4.7","31.8","1846","12.2","1848","12.2","15150","1011","1011","5382","16014","24663","40677","20.6","8.1","17324","31519","14195","15.9","7.2"
"Arizona","2000","1847766","77985","87115","4.7","32.0","13712","14.0","11979","12.2","98974","7340","7340","48971","155321","227451","382772","20.7","8.4","184900","295657","110757","16.0","6.0"
"Arkansas","2000","966824","44950","39061","4.0","24.4","6155","11.1","6262","11.3","55464","3935","3935","21571","55759","101225","156984","16.2","5.8","73193","117923","44730","12.2","4.6"
"California","2000","12366627","561944","519699","4.2","31.0","87448","12.7","77832","11.3","693690","47652","47652","340240","894539","1544689","2439228","19.7","7.2","1145153","1919529","774376","15.5","6.3"
"Colorado","2000","1837443","96551","85313","4.7","30.0","15957","13.8","13664","11.8","116723","8226","8226","49185","140127","221235","361362","19.7","7.6","167981","276049","108068","15.0","5.9"
"Connecticut","2000","1526209","68709","17762","1.1","27.0","7922","9.6","7851","9.6","82209","4762","4762","25714","77789","145399","223188","14.6","5.1","131604","205426","73822","13.5","4.8"
"Delaware","2000","359767","17020","19885","5.5","28.2","2678","13.3","2146","10.6","20483","1212","1212","7039","32287","38304","70591","19.6","9.0","31126","50706","19580","14.1","5.4"
"District of Columbia","2000","413452","14742","14049","3.4","24.0","1767","9.9","1647","9.2","17959","859","859","6148","22888","40716","63604","15.4","5.5","35395","49555","14160","12.0","3.4"
"Florida","2000","6014073","296984","264744","4.4","32.6","49447","13.4","47516","12.9","369079","29723","29723","201669","475633","768739","1244372","20.7","7.9","546440","979628","433188","16.3","7.2"
"Geogia","2000","3355840","136525","103055","3.0","31.2","22990","13.2","20683","11.9","175134","12378","12378","79942","242657","382836","625493","18.6","7.2","307244","522438","215194","15.6","6.4"
"Hawaii","2000","422616","21406","15823","3.7","22.4","2660","10.0","2506","9.4","26777","1497","1497","8548","23476","39567","63043","14.9","5.6","26570","47220","20650","11.2","4.9"
"Idaho","2000","436045","26837","13832","3.2","30.4","4129","13.0","3780","11.9","31990","2305","2305","12297","33796","46461","80257","18.4","7.8","42303","66425","24122","15.2","5.5"
"Illinois","2000","5335814","220130","136474","2.6","27.4","28274","10.4","26957","9.9","272309","16054","16054","109843","294167","575029","869196","16.3","5.5","456376","732722","276346","13.7","5.2"
"Indiana","2000","2593040","102577","77318","3.0","24.6","13046","9.9","13309","10.1","131892","8024","8024","52546","137739","258759","396498","15.3","5.3","201487","319180","117693","12.3","4.5"
"Iowa","2000","1250147","57722","46685","3.7","22.8","6598","9.1","6606","9.1","72646","4074","4074","22480","66168","123192","189360","15.1","5.3","90989","142675","51686","11.4","4.1"
"Kansas","2000","1102222","53560","21338","2.0","28.2","7061","10.6","6821","10.3","66493","4153","4153","23088","72320","104853","177173","16.1","6.6","98538","155835","57297","14.1","5.2"
"Kentucky","2000","1477266","63907","50395","3.4","25.2","8477","10.5","8287","10.2","81160","5232","5232","34675","89655","147159","236814","16.0","6.1","117096","186419","69323","12.6","4.7"
"Louisiana","2000","1559029","71934","20910","1.4","31.2","9531","10.5","9645","10.6","90889","5824","5824","48243","107273","157401","264674","17.0","6.9","152294","243764","91470","15.6","5.9"
"Maine","2000","474378","28597","21344","4.5","23.4","3711","11.0","3242","9.6","33840","2100","2100","11040","29762","47086","76848","16.2","6.3","33833","55504","21671","11.7","4.6"
"Maryland","2000","1990097","90656","78742","3.9","27.8","12331","11.0","11662","10.4","112476","6837","6837","42113","125096","230097","355193","17.8","6.3","169706","276451","106745","13.9","5.4"
"Massachusetts","2000","2982428","124069","94935","3.2","27.4","15613","10.4","14090","9.4","151194","8535","8535","58687","168645","335200","503845","16.9","5.7","255478","408910","153432","13.7","5.1"
"Michigan","2000","3979100","166749","70782","1.8","28.4","21112","10.1","20624","9.9","208597","12093","12093","84037","220770","416183","636953","16.0","5.5","345056","566171","221115","14.2","5.6"
"Minnesota","2000","2349577","98618","72301","3.1","24.6","12525","10.4","11080","9.2","121016","6648","6648","44254","119204","242571","361775","15.4","5.1","195736","289474","93738","12.3","4.0"
"Mississippi","2000","942438","42462","8806","0.9","27.2","5870","10.9","5940","11.1","53669","3804","3804","21377","51636","84958","136594","14.5","5.5","81401","127788","46387","13.6","4.9"
"Missouri","2000","2349679","103797","43728","1.8","27.8","14137","10.9","13673","10.6","129790","8618","8618","49124","134026","235434","369460","15.7","5.7","210715","325732","115017","13.9","4.9"
"Montana","2000","288981","23416","11118","3.9","27.0","3293","12.2","2934","10.9","27189","1913","1913","8158","18903","31251","50154","17.4","6.5","24174","39036","14862","13.5","5.1"
"Nebraska","2000","741038","36078","17860","2.5","25.6","4361","9.9","3984","9.1","44077","2406","2406","16953","43806","69246","113052","15.3","5.9","60867","95192","34325","12.8","4.6"
"Nevada","2000","869240","33092","55298","6.4","28.6","6641","16.6","5357","13.4","40749","3312","3312","22549","72114","107584","179698","20.7","8.3","76933","124400","47467","14.3","5.5"
"New Hampshire","2000","530530","27967","19093","3.6","25.2","3503","10.6","3216","9.8","33131","1970","1970","11231","29436","56423","85859","16.2","5.5","42588","66766","24178","12.6","4.6"
"New Jersey","2000","3456600","173288","97552","2.9","29.4","22814","11.2","21309","10.5","203567","13449","13449","81044","211730","395620","607350","17.6","6.1","312000","509798","197798","14.7","5.7"
"New Mexico","2000","538049","30581","8335","1.5","31.8","4468","11.8","4490","11.9","37730","2733","2733","16434","38027","55698","93725","17.4","7.1","50624","85390","34766","15.9","6.5"
"New York","2000","7178005","363018","221652","3.1","26.6","47749","11.2","43678","10.2","429059","28531","28531","170748","419092","760737","1179829","16.4","5.8","589360","958177","368817","13.3","5.1"
"North Carolina","2000","3317681","141638","81489","2.4","27.4","20557","11.4","19148","10.6","180802","11751","11751","71637","197335","337201","534536","16.1","5.9","281090","453047","171957","13.7","5.2"
"North Dakota","2000","250353","15073","6350","2.6","23.8","1559","8.6","1616","9.0","18027","1069","1069","6045","13132","23070","36202","14.5","5.2","19401","29852","10451","11.9","4.2"
"Ohio","2000","4892725","188238","154038","3.2","25.6","23147","9.5","22688","9.3","244720","13556","13556","86956","265036","515549","780585","16.0","5.4","405434","626547","221113","12.8","4.5"
"Oklahoma","2000","1175489","61070","38189","3.2","28.2","8310","11.0","8395","11.1","75646","5234","5234","28906","79704","124195","203899","17.3","6.8","102876","165710","62834","14.1","5.3"
"Oregon","2000","1324924","72295","20046","1.5","30.0","10014","11.5","9974","11.4","87439","6119","6119","33199","84082","134339","218421","16.5","6.3","121255","198375","77120","15.0","5.8"
"Pennsylvania","2000","4971087","210447","137496","2.8","25.6","25125","9.5","23948","9.0","266137","14498","14498","88698","291054","484036","775090","15.6","5.9","414005","637594","223589","12.8","4.5"
"Rhode Island","2000","404722","22084","6495","1.6","30.2","2531","10.1","2382","9.5","25111","1542","1542","11528","26429","41319","67748","16.7","6.5","34913","61253","26340","15.1","6.5"
"South Carolina","2000","1560666","68344","44158","2.8","27.4","10080","11.7","9404","10.9","86570","5812","5812","35450","93014","164917","257931","16.5","6.0","130987","213773","82786","13.7","5.3"
"South Dakota","2000","295618","17762","9027","3.1","25.6","2095","10.0","2007","9.6","20926","1291","1291","7058","16498","30472","46970","15.9","5.6","23774","37943","14169","12.8","4.8"
"Tennessee","2000","2339128","90450","66252","2.8","29.2","13103","11.1","13163","11.1","118294","7948","7948","49047","150201","257480","407681","17.4","6.4","206620","341429","134809","14.6","5.8"
"Texas","2000","7749247","318595","273715","3.5","31.8","51003","12.3","48855","11.7","417447","29168","29168","208499","569578","934813","1504391","19.4","7.4","729102","1230676","501574","15.9","6.5"
"Utah","2000","889847","38193","30670","3.4","29.6","6721","14.5","5515","11.9","47093","3487","3487","24343","61972","100103","162075","18.2","7.0","82996","131405","48409","14.8","5.4"
"Vermont","2000","248029","16515","8815","3.6","23.6","1834","9.7","1662","8.8","18914","1083","1083","5465","13189","24933","38122","15.4","5.3","19051","29307","10256","11.8","4.1"
"Virginia","2000","2788993","121162","117745","4.2","27.6","17668","11.4","15947","10.3","156036","9327","9327","51568","184840","316851","501691","18.0","6.6","232887","383946","151059","13.8","5.4"
"Washington","2000","2184773","116764","83499","3.8","29.2","17470","12.3","16919","12.0","141812","10371","10384","54359","149129","253841","402970","18.4","6.8","200095","319471","119376","14.6","5.5"
"West Virginia","2000","544619","30005","15385","2.8","24.4","3640","9.7","3724","9.9","37408","2293","2293","12137","31153","50771","81924","15.0","5.7","42979","66539","23560","12.2","4.3"
"Wisconsin","2000","2362182","101223","58672","2.4","23.2","12136","9.7","11169","8.9","125363","7020","7020","40792","115863","216019","331882","14.0","4.9","177840","273210","95370","11.6","4.0"
"Wyoming","2000","168352","13540","6477","3.8","28.6","1838","11.8","1634","10.5","15699","1047","1047","4695","11519","18951","30470","18.1","6.8","14763","23993","9230","14.3","5.5"
"Alabama","2001","1626673","69944","-47385","-2.9","27.2","9527","10.6","10346","11.5","90025","6197","6199","42560","85494","135013","220507","13.6","5.3","175826","267892","92066","16.5","5.7"
"Alaska","2001","208374","12678","7411","3.6","29.4","1864","12.2","1832","12.0","15343","972","972","5256","13591","24478","38069","18.3","6.5","19408","30658","11250","14.7","5.4"
"Arizona","2001","1918356","79694","41239","2.2","34.6","14262","14.2","12434","12.4","101651","7096","7098","49511","161875","211901","373776","19.5","8.4","204400","332537","128137","17.3","6.7"
"Arkansas","2001","986697","45032","-6275","-0.6","28.4","6273","11.2","6248","11.2","56033","3834","3835","21105","50733","89320","140053","14.2","5.1","98022","146328","48306","14.8","4.9"
"California","2001","12853482","571399","315914","2.4","32.0","91153","13.0","82934","11.8","708631","49615","49652","338175","880161","1488457","2368618","18.4","6.8","1287917","2052704","764787","16.0","6.0"
"Colorado","2001","1922140","98877","63673","3.4","33.4","16889","14.2","14312","12.1","120300","8451","8455","51653","154115","231295","385410","20.1","8.0","198177","321737","123560","16.7","6.4"
"Connecticut","2001","1552569","68662","14676","0.9","27.6","8123","9.8","8104","9.8","82835","4756","4757","27516","85479","142837","228316","14.7","5.5","135598","213640","78042","13.8","5.0"
"Delaware","2001","375393","17461","8229","2.2","28.6","2586","12.4","2183","10.5","21158","1228","1229","8366","21544","40364","61908","16.5","5.7","35913","53679","17766","14.3","4.7"
"District of Columbia","2001","426146","14935","5140","1.2","28.0","1851","10.2","1708","9.4","18263","834","836","5526","25164","39639","64803","15.2","5.9","38360","59663","21303","14.0","5.0"
"Florida","2001","6314237","302106","238591","3.8","34.0","52274","14.0","47309","12.7","377249","28334","28352","174434","495122","819132","1314254","20.8","7.8","671275","1075663","404388","17.0","6.4"
"Geogia","2001","3422997","138392","6725","0.2","32.8","23108","13.1","21280","12.0","178374","12062","12065","81194","235825","331508","567333","16.6","6.9","362493","560608","198115","16.4","5.8"
"Hawaii","2001","442622","21797","13719","3.1","24.6","2842","10.5","2514","9.3","27349","1430","1432","10292","29171","38982","68153","15.4","6.6","33609","54434","20825","12.3","4.7"
"Idaho","2001","454862","27210","19641","4.4","30.2","4375","13.5","4205","13.0","32501","2280","2281","12995","39078","49432","88510","19.5","8.6","42377","68869","26492","15.1","5.8"
"Illinois","2001","5404861","220398","-44640","-0.8","28.4","27505","10.1","27609","10.1","274076","16091","16113","103056","286198","482394","768592","14.2","5.3","548408","813232","264824","15.0","4.9"
"Indiana","2001","2615485","102294","-51740","-2.0","26.8","13111","9.9","13701","10.4","132320","7875","7884","53717","127014","223587","350601","13.4","4.9","271935","402341","130406","15.4","5.0"
"Iowa","2001","1263210","57289","-31851","-2.5","23.8","6332","8.7","7083","9.7","72582","4090","4091","22318","55946","93812","149758","11.9","4.4","130937","181609","50672","14.4","4.0"
"Kansas","2001","1111170","53619","-13998","-1.2","27.0","6975","10.4","7139","10.7","66947","4205","4206","25623","58989","90598","149587","13.5","5.3","107686","163585","55899","14.7","5.0"
"Kentucky","2001","1503542","64049","-14307","-0.9","27.4","8280","10.2","8462","10.4","81568","4979","4986","30972","73634","132060","205694","13.7","4.9","144557","220001","75444","14.6","5.0"
"Louisiana","2001","1578606","72179","387","0.0","31.0","9496","10.4","9722","10.6","91480","5564","5566","35934","93278","152184","245462","15.5","5.9","162727","245075","82348","15.5","5.2"
"Maine","2001","489722","28946","6070","1.2","26.4","3818","11.2","3456","10.1","34493","2117","2120","10394","28614","41961","70575","14.4","5.8","42741","64505","21764","13.2","4.4"
"Maryland","2001","2056774","92068","37325","1.8","28.2","12957","11.4","11858","10.4","114470","6544","6550","45878","126399","201457","327856","15.9","6.1","183987","290531","106544","14.1","5.2"
"Massachusetts","2001","3065034","126708","44118","1.4","28.4","15856","10.3","14960","9.7","154531","8721","8725","66905","160205","319255","479460","15.6","5.2","288255","435342","147087","14.2","4.8"
"Michigan","2001","3998139","166342","-55011","-1.4","29.8","21307","10.2","21735","10.4","209731","12482","12489","87752","228113","367891","596004","14.9","5.7","433380","651015","217635","16.3","5.4"
"Minnesota","2001","2399005","99939","10401","0.4","27.8","13694","11.2","11798","9.6","123789","6682","6687","46186","135742","207837","343579","14.3","5.7","221727","333178","111451","13.9","4.6"
"Mississippi","2001","935461","42100","-32325","-3.4","26.6","5734","10.7","6364","11.9","53495","3753","3753","21882","47808","76493","124301","13.3","5.1","102643","156626","53983","16.7","5.8"
"Missouri","2001","2382147","103413","2828","0.1","28.6","13378","10.3","13917","10.7","130311","8459","8461","49673","127103","215670","342773","14.4","5.3","226211","339945","113734","14.3","4.8"
"Montana","2001","298356","23852","4330","1.4","29.4","3281","11.9","2963","10.8","27812","1752","1753","8125","19130","28989","48119","16.1","6.4","29461","43789","14328","14.7","4.8"
"Nebraska","2001","749552","36406","-5173","-0.7","27.6","4460","10.0","4290","9.6","44724","2408","2408","13455","44434","59073","103507","13.8","5.9","70091","108680","38589","14.5","5.1"
"Nevada","2001","907096","33891","15549","1.7","31.4","6678","16.1","5856","14.2","41920","3582","3584","25955","65893","92385","158278","17.4","7.3","92296","142729","50433","15.7","5.6"
"New Hampshire","2001","547963","28145","13000","2.4","26.4","3499","10.5","3389","10.2","33445","2063","2064","12603","29307","56046","85353","15.6","5.3","46315","72353","26038","13.2","4.8"
"New Jersey","2001","3563025","175063","86464","2.4","29.4","23262","11.3","21951","10.7","206569","13346","13347","85222","240890","369451","610341","17.1","6.8","341171","523877","182706","14.7","5.1"
"New Mexico","2001","546938","30774","3580","0.7","33.8","4578","12.1","4550","12.0","38131","2497","2497","14767","38876","57175","96051","17.6","7.1","57683","92471","34788","16.9","6.4"
"New York","2001","7342423","368613","32724","0.5","28.4","48541","11.2","45728","10.5","435878","28441","28461","174109","400677","678143","1078820","14.7","5.5","671488","1046096","374608","14.2","5.1"
"North Carolina","2001","3406151","143568","60789","1.8","30.4","21575","11.8","19914","10.9","183926","11493","11500","66882","214223","363258","577481","17.0","6.3","333705","516692","182987","15.2","5.4"
"North Dakota","2001","254796","15086","841","0.4","25.2","1588","8.8","1639","9.0","18151","1000","1000","5891","13755","19278","33033","13.0","5.4","22000","32192","10192","12.6","4.0"
"Ohio","2001","4949147","187800","-80847","-1.6","26.8","23095","9.4","23364","9.5","245998","13423","13444","88090","246386","415749","662135","13.4","5.0","512792","742982","230190","15.0","4.7"
"Oklahoma","2001","1201711","61201","2451","0.2","31.8","8402","11.0","8498","11.2","76322","5097","5099","29226","74467","118871","193338","16.1","6.2","116649","190887","74238","15.9","6.2"
"Oregon","2001","1341484","73206","2458","0.2","31.0","10769","12.2","10097","11.4","89075","5981","5993","30655","80225","130535","210760","15.7","6.0","142392","208302","65910","15.5","4.9"
"Pennsylvania","2001","5074989","211582","28363","0.6","27.6","25913","9.7","24685","9.2","269387","14410","14416","97846","280974","449700","730674","14.4","5.5","466138","702311","236173","13.8","4.7"
"Rhode Island","2001","408389","22226","-996","-0.2","26.0","2523","10.0","2461","9.7","25350","1549","1549","7742","19288","33763","53051","13.0","4.7","38614","54047","15433","13.2","3.8"
"South Carolina","2001","1589658","68591","-8380","-0.5","30.2","10050","11.5","10038","11.5","87289","6004","6009","36357","93277","146529","239806","15.1","5.9","165718","248186","82468","15.6","5.2"
"South Dakota","2001","307900","17903","9565","3.2","26.2","2148","10.2","2125","10.1","21198","1251","1252","6609","22592","27453","50045","16.3","7.3","27480","40480","13000","13.1","4.2"
"Tennessee","2001","2370562","89932","-20073","-0.9","30.2","12811","10.8","13509","11.4","118501","7899","7905","58086","131928","226740","358668","15.1","5.6","244153","378741","134588","16.0","5.7"
"Texas","2001","7990254","322309","150390","1.8","33.0","53003","12.6","48836","11.6","425543","28655","28682","196233","603497","861919","1465416","18.3","7.6","807853","1315026","507173","16.5","6.3"
"Utah","2001","909500","39288","984","0.1","36.4","7133","14.9","6324","13.2","48305","3523","3528","27749","65353","100834","166187","18.3","7.2","98802","165203","66401","18.2","7.3"
"Vermont","2001","256558","16646","6101","2.3","22.2","1750","9.2","1690","8.9","19155","1084","1084","5399","12198","22299","34497","13.4","4.8","18864","28396","9532","11.1","3.7"
"Virginia","2001","2885172","123022","46525","1.6","30.2","17854","11.3","16430","10.4","158779","9107","9112","54802","189811","291996","481807","16.7","6.6","296857","435282","138425","15.1","4.8"
"Washington","2001","2240956","117733","10558","0.5","32.2","18076","12.6","17248","12.1","143923","10084","10095","62798","145408","225852","371260","16.6","6.5","234359","360702","126343","16.1","5.6"
"West Virginia","2001","552784","29540","-5911","-1.0","27.4","3302","8.9","4006","10.8","36987","2339","2340","11187","26161","49299","75460","13.7","4.7","50911","81371","30460","14.7","5.5"
"Wisconsin","2001","2390908","101603","-17556","-0.7","25.2","11968","9.5","11797","9.4","126533","6965","6976","42174","112822","187993","300815","12.6","4.7","217228","318371","101143","13.3","4.2"
"Wyoming","2001","173823","13730","2830","1.6","30.2","1860","11.7","1824","11.5","15934","1065","1066","5007","11087","17918","29005","16.7","6.4","17005","26175","9170","15.1","5.3"
"Alabama","2002","1588248","70077","-32807","-2.1","32.2","10991","12.2","10373","11.5","90514","5783","5792","34380","105218","150514","255732","16.1","6.6","189444","288539","99095","18.2","6.2"
"Alaska","2002","212680","12843","2995","1.4","35.6","2236","14.5","1924","12.5","15592","932","934","4977","15967","24780","40747","19.2","7.5","25861","37752","11891","17.8","5.6"
"Arizona","2002","1927572","80863","-16219","-0.8","39.6","15428","15.1","13663","13.3","103369","7333","7355","49935","159839","221623","381462","19.8","8.3","259954","397681","137727","20.6","7.1"
"Arkansas","2002","977695","45485","-8875","-1.0","32.6","7343","13.0","6439","11.4","56845","3703","3707","20029","67379","92462","159841","16.3","6.9","106263","168716","62453","17.3","6.4"
"California","2002","12818076","576942","-267101","-2.1","37.0","101565","14.3","91260","12.8","717239","51010","51162","401927","1015751","1359862","2375613","18.5","7.9","1691914","2642714","950800","20.6","7.4"
"Colorado","2002","1912195","99866","-80277","-4.2","35.6","17767","14.7","16288","13.5","121531","8576","8590","51313","146320","194408","340728","17.8","7.7","260877","421005","160128","22.0","8.4"
"Connecticut","2002","1554153","68260","4504","0.2","31.8","8852","10.7","8968","10.9","82553","4544","4547","27319","99528","151322","250850","16.1","6.4","166956","246346","79390","15.9","5.1"
"Delaware","2002","383522","17517","4661","1.2","33.8","2902","13.6","2437","11.4","21580","1234","1240","6142","32164","37264","69428","18.1","8.4","43173","64767","21594","16.9","5.6"
"District of Columbia","2002","427741","15152","-284","-0.1","33.6","2295","12.5","2025","11.0","18529","865","868","7973","31071","40880","71951","16.8","7.3","49156","72235","23079","16.9","5.4"
"Florida","2002","6304447","308428","-64274","-1.1","38.8","58518","15.4","51516","13.5","383859","28433","28494","191699","507347","718264","1225611","19.4","8.0","714620","1289885","575265","20.5","9.1"
"Geogia","2002","3393411","140616","-56528","-1.7","35.0","25802","14.4","23077","12.9","180878","11952","11977","90644","267020","326671","593691","17.5","7.9","406349","650219","243870","19.2","7.2"
"Hawaii","2002","445033","22048","-10682","-2.4","30.2","3229","11.8","2943","10.7","27588","1511","1515","8821","27456","39740","67196","15.1","6.2","54631","77878","23247","17.5","5.2"
"Idaho","2002","458027","27706","-9373","-2.0","36.4","4788","14.6","4088","12.5","33112","2093","2112","16533","37873","45457","83330","18.2","8.3","60499","92703","32204","20.2","7.0"
"Illinois","2002","5279031","219136","-179117","-3.4","30.6","31177","11.4","31806","11.6","273122","15654","15725","107232","333176","475042","808218","15.3","6.3","647245","987335","340090","18.7","6.4"
"Indiana","2002","2546235","102674","-63509","-2.5","29.8","15292","11.5","14632","11.0","132863","7349","7378","47962","161667","216840","378507","14.9","6.3","299543","442016","142473","17.4","5.6"
"Iowa","2002","1235896","57207","-12663","-1.1","27.6","7519","10.4","7357","10.1","72588","3671","3682","21751","72984","98181","171165","13.8","5.9","122286","183828","61542","14.9","5.0"
"Kansas","2002","1098925","53656","-6118","-0.6","32.6","7952","11.9","7672","11.5","67138","4004","4011","22995","76975","102517","179492","16.3","7.0","123226","185610","62384","16.9","5.7"
"Kentucky","2002","1480511","64117","-24142","-1.6","30.2","9406","11.5","8778","10.7","82105","4805","4821","28352","91147","132096","223243","15.1","6.2","171810","247385","75575","16.7","5.1"
"Louisiana","2002","1568055","72883","-10001","-0.7","33.6","10721","11.7","9831","10.7","92272","5323","5333","39257","107376","156462","263838","16.8","6.8","178365","273839","95474","17.5","6.1"
"Maine","2002","485972","28897","-10955","-2.3","29.2","4072","11.8","3934","11.4","34629","2049","2050","12442","30160","40853","71013","14.6","6.2","53199","81968","28769","16.9","5.9"
"Maryland","2002","2057930","93310","-10046","-0.4","33.6","14648","12.7","12973","11.3","115980","6443","6456","48761","145830","199020","344850","16.8","7.1","227478","354896","127418","17.2","6.2"
"Massachusetts","2002","3034533","126934","-83671","-2.8","31.4","17807","11.5","16443","10.6","155655","8493","8501","64209","193803","283831","477634","15.7","6.4","370996","561305","190309","18.5","6.3"
"Michigan","2002","3916952","165183","-97412","-2.4","32.2","24375","11.7","25407","12.2","208342","12314","12353","86366","270925","357784","628709","16.1","6.9","467709","726121","258412","18.5","6.6"
"Minnesota","2002","2376190","99908","-31919","-1.4","30.8","14588","11.8","14002","11.3","124221","6829","6841","45248","143375","222971","366346","15.4","6.0","263594","398265","134671","16.8","5.7"
"Mississippi","2002","906736","42445","-14591","-1.6","31.2","6656","12.4","6165","11.5","53952","3472","3478","20344","61746","79997","141743","15.6","6.8","99924","156334","56410","17.2","6.2"
"Missouri","2002","2361022","104206","-34640","-1.4","32.0","16576","12.7","15145","11.6","131575","8174","8183","53275","156986","219855","376841","16.0","6.6","272489","411481","138992","17.4","5.9"
"Montana","2002","299093","24027","961","0.3","33.6","3588","12.8","3268","11.7","28084","1755","1756","7788","20529","30704","51233","17.1","6.9","33915","50272","16357","16.8","5.5"
"Nebraska","2002","745089","36585","3318","0.4","29.0","4951","11.0","4559","10.2","45065","2372","2376","12600","41540","69820","111360","14.9","5.6","73680","108042","34362","14.5","4.6"
"Nevada","2002","927089","34901","7423","0.8","36.8","7492","17.6","6002","14.1","43335","3423","3425","24374","79909","97717","177626","19.2","8.6","115920","170203","54283","18.4","5.9"
"New Hampshire","2002","544591","28009","-14121","-2.6","29.0","3790","11.3","3717","11.1","33463","2046","2047","11745","30642","48111","78753","14.5","5.6","60112","92874","32762","17.1","6.0"
"New Jersey","2002","3579695","175184","-8786","-0.3","34.2","25434","12.3","24119","11.7","207594","13393","13414","81982","233694","380141","613835","17.1","6.5","407585","622621","215036","17.4","6.0"
"New Mexico","2002","547163","31067","6008","1.1","35.6","5033","13.2","4763","12.5","38353","2439","2440","14833","44765","58435","103200","18.9","8.2","61844","97192","35348","17.8","6.5"
"New York","2002","7307112","369756","-75477","-1.1","33.8","53883","12.4","51539","11.8","437453","29028","29059","183648","509627","726960","1236587","16.9","7.0","816115","1312064","495949","18.0","6.8"
"North Carolina","2002","3379608","143912","-89174","-2.6","30.6","22739","12.3","21563","11.7","184890","11442","11477","67807","223471","293544","517015","15.3","6.6","404480","606189","201709","17.9","6.0"
"North Dakota","2002","253617","14977","-2347","-0.9","29.8","1795","9.9","1746","9.6","18155","925","925","5854","17757","19921","37678","14.9","7.0","26389","40025","13636","15.8","5.4"
"Ohio","2002","4821129","186689","-134096","-2.8","30.2","25753","10.5","26668","10.9","244789","13067","13096","93834","289367","438515","727882","15.1","6.0","590475","861978","271503","17.9","5.6"
"Oklahoma","2002","1192062","62013","-5921","-0.5","35.2","9589","12.5","8780","11.5","77044","4748","4765","32902","86079","123273","209352","17.6","7.2","135436","215273","79837","18.1","6.7"
"Oregon","2002","1329790","73305","-19735","-1.5","33.2","11457","12.8","10834","12.2","89479","5796","5811","32834","95654","125498","221152","16.6","7.2","159713","240887","81174","18.1","6.1"
"Pennsylvania","2002","5067158","211471","-13154","-0.2","32.4","28418","10.6","28005","10.4","269383","13921","13966","99813","336093","484156","820249","16.2","6.6","514103","833403","319300","16.4","6.3"
"Rhode Island","2002","411589","22155","4728","1.1","29.2","2820","11.1","2762","10.9","25365","1465","1465","7185","26949","37700","64649","15.7","6.5","40741","59921","19180","14.6","4.7"
"South Carolina","2002","1553749","69041","-43480","-2.8","31.2","11069","12.6","10240","11.7","88108","5673","5684","35152","101660","140654","242314","15.6","6.5","195358","285794","90436","18.4","5.8"
"South Dakota","2002","307387","18176","-10328","-3.4","32.0","2647","12.4","2180","10.2","21627","1223","1223","7221","18589","30728","49317","16.0","6.0","36328","59645","23317","19.4","7.6"
"Tennessee","2002","2317203","89467","-66565","-2.9","31.4","14063","11.9","14299","12.1","118103","7673","7698","50428","147901","215729","363630","15.7","6.4","279093","430195","151102","18.6","6.5"
"Texas","2002","7985108","326189","-68744","-0.9","37.4","58380","13.6","52959","12.4","430507","28205","28305","194401","670544","824712","1495256","18.7","8.4","996179","1564000","567821","19.6","7.1"
"Utah","2002","908421","40563","-4053","-0.5","36.8","8077","16.5","6580","13.4","49692","3412","3418","26180","73245","94198","167443","18.4","8.1","110734","171496","60762","18.9","6.7"
"Vermont","2002","259289","16540","-610","-0.2","30.8","1962","10.3","2077","10.9","19030","1052","1053","5950","16039","23799","39838","15.4","6.2","25797","40448","14651","15.6","5.7"
"Virginia","2002","2901575","124823","-16818","-0.6","34.0","20335","12.7","17816","11.1","161150","9013","9032","60569","206894","285996","492890","17.0","7.1","324099","509708","185609","17.6","6.4"
"Washington","2002","2208713","117722","-56586","-2.6","34.4","19689","13.7","18940","13.2","144263","10245","10267","61774","181095","199353","380448","17.2","8.2","297215","437034","139819","19.8","6.3"
"West Virginia","2002","552933","29297","6440","1.1","31.0","3971","10.8","4058","11.0","36872","2191","2196","11746","31672","60368","92040","16.6","5.7","54764","85600","30836","15.5","5.6"
"Wisconsin","2002","2368803","101507","-27643","-1.1","28.4","13623","10.8","13193","10.4","126757","6802","6821","44492","131810","203677","335487","14.2","5.6","249088","363130","114042","15.3","4.8"
"Wyoming","2002","175727","14094","981","0.6","37.0","2247","13.9","1843","11.4","16311","1014","1015","5185","13691","19817","33508","19.1","7.8","19350","32527","13177","18.5","7.5"
"Alabama","2003","1568996","70389","38229","2.5","27.0","10017","11.1","7888","8.7","91024","5758","5760","34078","90416","159918","250334","16.0","5.8","149362","212105","62743","13.5","4.0"
"Alaska","2003","215035","13024","8416","3.9","30.4","2090","13.4","1509","9.7","15833","893","893","4825","15157","25853","41010","19.1","7.0","23074","32594","9520","15.2","4.4"
"Arizona","2003","1925357","82422","73370","3.9","32.2","14952","14.4","10806","10.4","105379","7307","7326","56271","147241","236869","384110","20.0","7.6","208342","310740","102398","16.1","5.3"
"Arkansas","2003","970507","46058","21918","2.3","24.4","6808","11.9","4963","8.7","57745","3674","3680","19933","47854","92802","140656","14.5","4.9","84727","118738","34011","12.2","3.5"
"California","2003","12663136","584851","326405","2.6","31.2","97057","13.5","74727","10.4","726275","51510","52205","375679","868476","1438191","2306667","18.2","6.9","1337832","1980262","642430","15.6","5.1"
"Colorado","2003","1849474","101302","5225","0.3","33.8","17237","14.2","13279","10.9","123153","8630","8642","57235","132282","185441","317723","17.2","7.2","203110","312498","109388","16.9","5.9"
"Connecticut","2003","1540149","67782","11424","0.7","26.2","7787","9.5","7201","8.8","82021","4611","4617","27701","61698","150777","212475","13.8","4.0","135359","201051","65692","13.1","4.3"
"Delaware","2003","381541","17769","-2510","-0.7","27.0","2620","12.1","1963","9.1","21872","1290","1292","7643","19469","32226","51695","13.5","5.1","36243","54205","17962","14.2","4.7"
"District of Columbia","2003","423505","15058","7466","1.7","24.6","1733","9.4","1493","8.1","18440","893","893","6472","19317","40067","59384","14.0","4.6","38691","51918","13227","12.3","3.1"
"Florida","2003","6279440","318351","230209","3.7","33.6","60406","15.6","42614","11.0","394031","29592","29664","219878","525256","761923","1287179","20.5","8.4","655961","1056970","401009","16.8","6.4"
"Geogia","2003","3328426","143256","44736","1.3","30.2","24713","13.6","18127","10.0","183617","12107","12122","78635","215831","330007","545838","16.4","6.5","347402","501102","153700","15.1","4.6"
"Hawaii","2003","447271","22481","22206","5.0","22.0","3056","11.0","2147","7.8","28057","1470","1470","10795","23990","47401","71391","16.0","5.4","31097","49185","18088","11.0","4.0"
"Idaho","2003","456694","28547","16691","3.6","27.4","4805","14.4","3273","9.8","34059","2198","2209","11615","28691","50477","79168","17.3","6.3","42847","62477","19630","13.7","4.3"
"Illinois","2003","5159626","220163","65701","1.2","27.2","29869","11.0","24031","8.8","274745","15508","15604","110540","261102","503801","764903","14.8","5.1","481367","699202","217835","13.6","4.2"
"Indiana","2003","2507247","102801","59506","2.3","25.6","13499","10.2","10945","8.3","133203","7372","7443","51394","126939","252379","379318","15.1","5.1","219416","319812","100396","12.8","4.0"
"Iowa","2003","1220835","57316","12663","1.0","24.0","7085","9.8","5830","8.1","72666","3751","3753","24463","57208","101590","158798","13.0","4.7","104906","146135","41229","12.0","3.4"
"Kansas","2003","1091202","53796","24751","2.3","25.8","7241","10.8","5852","8.7","67382","4015","4026","23483","68117","97430","165547","15.2","6.2","95759","140796","45037","12.9","4.1"
"Kentucky","2003","1464469","64051","22569","1.6","25.8","8384","10.2","6883","8.4","82328","4820","4858","31592","74923","136969","211892","14.5","5.1","132495","189323","56828","12.9","3.9"
"Louisiana","2003","1564329","73479","47240","3.0","26.6","9843","10.7","7552","8.2","92862","5399","5406","37997","85311","169899","255210","16.3","5.5","145551","207970","62419","13.3","4.0"
"Maine","2003","478773","29212","5974","1.2","26.0","3840","11.1","2968","8.6","35019","1927","1930","10872","25387","42710","68097","14.2","5.3","41815","62123","20308","13.0","4.2"
"Maryland","2003","2050427","94754","54092","2.7","26.6","13577","11.7","9990","8.6","117670","6499","6500","41351","117415","210091","327506","16.0","5.7","194067","273414","79347","13.3","3.9"
"Massachusetts","2003","2959415","128664","8928","0.3","28.0","17776","11.4","13751","8.8","157413","8819","8836","60245","143060","280409","423469","14.3","4.8","278595","414541","135946","14.0","4.6"
"Michigan","2003","3831397","164940","27508","0.7","29.6","22109","10.7","19051","9.2","208078","12311","12430","99286","220160","375393","595553","15.5","5.7","399601","568045","168444","14.8","4.4"
"Minnesota","2003","2355742","101285","39940","1.7","27.2","14378","11.5","10695","8.6","125911","6656","6659","47174","137249","223330","360579","15.3","5.8","224044","320639","96595","13.6","4.1"
"Mississippi","2003","895194","42757","17803","2.0","27.2","6213","11.5","4795","8.9","54397","3530","3533","23720","51295","88552","139847","15.6","5.7","86024","122044","36020","13.6","4.0"
"Missouri","2003","2346532","105596","61168","2.6","25.0","15854","12.0","12082","9.2","133144","8386","8394","49876","115837","238523","354360","15.1","4.9","202493","293192","90699","12.5","3.9"
"Montana","2003","301191","24613","8080","2.6","27.6","3559","12.6","2558","9.0","28690","1660","1661","7754","19833","29689","49522","16.4","6.6","28507","41442","12935","13.8","4.3"
"Nebraska","2003","746681","36878","24397","3.3","24.8","4581","10.2","3538","7.9","45452","2351","2352","12748","38431","78676","117107","15.7","5.1","66901","92710","25809","12.4","3.5"
"Nevada","2003","943439","36379","40485","4.3","28.2","7627","17.4","4950","11.3","45098","3478","3485","23116","70464","103129","173593","18.4","7.5","91313","133108","41795","14.1","4.4"
"New Hampshire","2003","529778","28078","3174","0.6","27.4","3682","11.0","3082","9.2","33604","2079","2080","11890","29234","46697","75931","14.3","5.5","49904","72757","22853","13.7","4.3"
"New Jersey","2003","3541138","175699","31998","0.9","30.8","24638","11.9","21006","10.1","208335","13887","13901","91754","208681","369358","578039","16.3","5.9","369407","546041","176634","15.4","5.0"
"New Mexico","2003","557231","31396","24158","4.4","27.0","4662","12.2","3578","9.3","38724","2349","2355","13916","38774","60772","99546","17.9","7.0","48424","75388","26964","13.5","4.8"
"New York","2003","7280882","374131","152779","2.1","27.4","52871","12.1","42837","9.8","442102","29545","29582","180548","393085","758952","1152037","15.8","5.4","685242","999258","314016","13.7","4.3"
"North Carolina","2003","3312400","145137","44463","1.4","29.4","21998","11.9","16816","9.1","186530","11385","11407","71088","211300","320724","532024","16.1","6.4","335721","487561","151840","14.7","4.6"
"North Dakota","2003","254197","15017","8090","3.1","21.6","1606","8.9","1311","7.2","18201","843","843","4879","11199","24233","35432","13.9","4.4","18796","27342","8546","10.8","3.4"
"Ohio","2003","4723630","186122","58360","1.2","26.6","23741","9.8","20094","8.3","244400","13109","13178","93232","232696","453927","686623","14.5","4.9","449362","628263","178901","13.3","3.8"
"Oklahoma","2003","1172193","62290","202","0.0","30.6","8663","11.3","6868","8.9","77491","5035","5039","30479","61419","117846","179265","15.3","5.2","126294","179063","52769","15.3","4.5"
"Oregon","2003","1318704","74412","26645","2.1","28.0","11231","12.5","8382","9.3","90720","5655","5660","32614","67079","144803","211882","16.1","5.1","123592","185237","61645","14.0","4.7"
"Pennsylvania","2003","5026353","211726","60228","1.1","27.2","26358","9.8","21653","8.1","270120","14244","14308","95614","254344","486959","741303","14.7","5.1","491347","681075","189728","13.6","3.8"
"Rhode Island","2003","415644","22410","9292","2.3","25.4","2840","11.2","2240","8.8","25649","1412","1420","8217","21020","41247","62267","15.0","5.1","37657","52975","15318","12.7","3.7"
"South Carolina","2003","1523515","69949","23933","1.6","29.0","10565","12.0","7889","8.9","89195","5619","5624","36313","100371","144715","245086","16.1","6.6","152642","221153","68511","14.5","4.5"
"South Dakota","2003","295917","18242","-2069","-0.7","27.8","2255","10.5","1900","8.8","21602","1204","1204","6292","14408","26632","41040","13.9","4.9","25090","43109","18019","14.6","6.1"
"Tennessee","2003","2270881","89753","42775","1.9","28.2","13491","11.5","10789","9.2","118634","7466","7478","49607","137790","225768","363558","16.0","6.1","227026","320783","93757","14.1","4.1"
"Texas","2003","7883519","329597","122935","1.5","32.6","55434","12.9","42723","9.9","434347","29295","29446","223940","559664","845745","1405409","17.8","7.1","834220","1282474","448254","16.3","5.7"
"Utah","2003","899056","41930","11130","1.2","33.4","8091","16.1","5868","11.7","51004","3807","3814","31165","70890","90285","161175","17.9","7.9","97444","150045","52601","16.7","5.9"
"Vermont","2003","256541","16607","393","0.2","27.8","2003","10.5","1578","8.3","19194","1033","1034","6301","12673","23435","36108","14.1","4.9","23975","35715","11740","13.9","4.6"
"Virginia","2003","2879374","126692","45396","1.5","27.8","19359","12.0","14040","8.7","163596","9154","9206","62298","163043","281813","444856","15.4","5.7","275201","399460","124259","13.9","4.3"
"Washington","2003","2176370","119368","45433","2.1","28.8","19070","13.2","14668","10.2","145955","9784","9801","52630","131187","227767","358954","16.5","6.0","207971","313521","105550","14.4","4.8"
"West Virginia","2003","552460","29068","5356","0.9","26.6","3580","9.8","3054","8.3","36719","2087","2092","11823","31680","46913","78593","14.2","5.7","53725","73237","19512","13.3","3.5"
"Wisconsin","2003","2353500","101373","46033","1.9","24.0","12450","9.9","10518","8.3","126867","6924","6949","44342","113807","214446","328253","13.9","4.8","201244","282220","80976","12.0","3.4"
"Wyoming","2003","175244","14253","3798","2.1","29.2","2006","12.3","1588","9.7","16463","1063","1068","5063","10152","19201","29353","16.7","5.8","17137","25555","8418","14.6","4.8"
"Alabama","2004","1593465","71030","37985","2.4","27.0","9704","10.7","8192","9.0","91635","5541","5556","35392","84394","168772","253166","15.9","5.3","140599","215181","74582","13.5","4.7"
"Alaska","2004","219737","13232","6638","3.0","26.6","2043","12.9","1602","10.1","16068","965","965","5012","10959","24833","35792","16.3","5.0","19098","29154","10056","13.3","4.6"
"Arizona","2004","1977291","84566","68285","3.5","30.0","14825","13.9","10886","10.2","107925","7127","7142","56581","131641","233678","365319","18.5","6.7","192558","297034","104476","15.0","5.3"
"Arkansas","2004","981830","46617","22963","2.3","24.2","6384","11.0","5260","9.1","58378","3732","3738","20883","45658","95949","141607","14.4","4.7","81248","118644","37396","12.1","3.8"
"California","2004","12857225","590973","312904","2.4","30.0","92650","12.7","77649","10.7","732203","52216","52330","382609","832114","1409387","2241501","17.4","6.5","1235775","1928597","692822","15.0","5.4"
"Colorado","2004","1859698","103024","44629","2.4","29.4","16774","13.5","13420","10.8","125166","8565","8587","50440","132009","186340","318349","17.1","7.1","178802","273720","94918","14.7","5.1"
"Connecticut","2004","1528447","68204","-12327","-0.8","25.0","8149","9.9","6792","8.3","82674","4370","4381","36689","63325","128158","191483","12.5","4.1","129606","203810","74204","13.3","4.9"
"Delaware","2004","383101","18122","5840","1.5","26.4","2678","12.1","1985","9.0","22370","1251","1258","6988","20542","35677","56219","14.7","5.4","32488","50379","17891","13.2","4.7"
"District of Columbia","2004","431361","14643","12701","2.9","21.4","1398","7.7","1550","8.5","18110","901","906","6219","17627","41130","58757","13.6","4.1","32615","46056","13441","10.7","3.1"
"Florida","2004","6415540","334147","134730","2.1","35.0","66023","16.4","44930","11.2","410603","30541","30753","206345","471338","783094","1254432","19.6","7.3","633262","1119702","486440","17.5","7.6"
"Geogia","2004","3367663","146935","108959","3.3","28.0","24233","13.1","18134","9.8","187539","11921","11960","78683","210294","371584","581878","17.3","6.2","311350","472919","161569","14.0","4.8"
"Hawaii","2004","464422","22874","15345","3.3","21.8","3007","10.6","2266","8.0","28569","1509","1509","9510","22358","43806","66164","14.2","4.8","34414","50819","16405","10.9","3.5"
"Idaho","2004","473118","29555","25375","5.4","26.2","4774","13.8","3374","9.8","35133","2136","2144","10303","40933","46540","87473","18.5","8.7","40527","62098","21571","13.1","4.6"
"Illinois","2004","5181021","222385","61866","1.2","26.6","29344","10.7","24749","9.0","276780","15326","15419","106565","244223","505596","749819","14.5","4.7","472816","687953","215137","13.3","4.2"
"Indiana","2004","2548059","103599","56872","2.2","23.8","13434","10.1","10980","8.2","134402","7304","7311","49983","119741","240665","360406","14.1","4.7","205458","303534","98076","11.9","3.8"
"Iowa","2004","1226941","57614","16642","1.3","23.2","6696","9.2","5895","8.1","72962","3776","3785","20449","49847","109018","158865","12.9","4.1","95278","142223","46945","11.6","3.8"
"Kansas","2004","1102299","54318","4991","0.4","26.2","6977","10.3","5827","8.6","67890","3816","3818","23437","55228","93919","149147","13.5","5.0","98268","144156","45888","13.1","4.2"
"Kentucky","2004","1469536","64571","35304","2.4","24.6","8383","10.2","7014","8.5","82909","4710","4716","32086","77019","139611","216630","14.7","5.2","119672","181326","61654","12.3","4.2"
"Louisiana","2004","1590616","74281","23208","1.4","27.6","9440","10.1","7831","8.4","93648","5313","5330","38543","75305","167019","242324","15.2","4.7","147702","219116","71414","13.8","4.5"
"Maine","2004","482117","29527","7040","1.5","22.6","3759","10.7","3083","8.8","35386","2024","2039","10874","20003","41473","61476","12.8","4.1","35555","54436","18881","11.3","3.9"
"Maryland","2004","2098798","96808","68371","3.2","25.4","13569","11.5","10333","8.7","119855","6570","6587","47411","114267","220015","334282","15.9","5.4","173718","265911","92193","12.7","4.4"
"Massachusetts","2004","2957921","127072","19149","0.6","25.4","15915","10.2","16230","10.4","155806","11444","11469","56978","137182","256564","393746","13.3","4.6","255707","374597","118890","12.7","4.0"
"Michigan","2004","3829976","165233","31570","0.8","27.6","21276","10.3","19453","9.4","207693","12029","12098","88558","205579","354027","559606","14.6","5.4","351697","528036","176339","13.8","4.6"
"Minnesota","2004","2371469","102969","16502","0.7","25.6","14153","11.2","10985","8.7","127848","6708","6723","48008","107975","211748","319723","13.5","4.6","199233","303221","103988","12.8","4.4"
"Mississippi","2004","910625","43115","22491","2.5","25.6","5819","10.7","4873","8.9","54880","3385","3396","19426","52764","86205","138969","15.3","5.8","75997","116478","40481","12.8","4.4"
"Missouri","2004","2375540","107735","36247","1.6","26.4","16213","12.1","12649","9.4","135422","8641","8644","53336","125140","225599","350739","14.8","5.3","204975","314492","109517","13.2","4.6"
"Montana","2004","307386","25346","10580","3.4","25.0","3783","13.0","2739","9.4","29441","1722","1723","8221","16973","31964","48937","15.9","5.5","23111","38357","15246","12.5","5.0"
"Nebraska","2004","762719","37146","17586","2.3","21.0","4373","9.6","3692","8.1","45736","2392","2413","12664","34275","63374","97649","12.8","4.5","56781","80063","23282","10.5","3.1"
"Nevada","2004","985030","38027","59757","6.0","26.6","7754","16.9","5290","11.5","46978","3598","3617","26286","70770","119549","190319","19.3","7.2","81434","130562","49128","13.3","5.0"
"New Hampshire","2004","533310","28530","9006","1.7","22.4","3776","11.2","2972","8.8","34129","2003","2020","12458","22461","46123","68584","12.9","4.2","38760","59578","20818","11.2","3.9"
"New Jersey","2004","3550917","177637","72094","2.0","27.8","24187","11.6","21544","10.3","209227","13785","13816","83009","182957","381929","564886","15.9","5.2","325559","492792","167233","13.9","4.7"
"New Mexico","2004","569294","31864","13484","2.3","28.0","4497","11.6","3600","9.3","39221","2352","2352","14107","33148","59851","92999","16.3","5.8","50412","79515","29103","14.0","5.1"
"New York","2004","7350398","378394","85162","1.1","27.4","53167","12.0","45249","10.2","446777","30312","30374","181217","369065","720941","1090006","14.8","5.0","680135","1004844","324709","13.7","4.4"
"North Carolina","2004","3319460","147765","42280","1.2","27.6","21541","11.5","16770","8.9","189305","11079","11119","73032","169950","328773","498723","15.0","5.1","307938","456443","148505","13.8","4.5"
"North Dakota","2004","259181","15238","5460","2.1","21.2","1662","9.1","1315","7.2","18416","872","872","4867","10083","22842","32925","12.7","3.9","16115","27465","11350","10.6","4.4"
"Ohio","2004","4726164","186189","24675","0.5","25.6","23242","9.5","20294","8.3","244899","13006","13057","104142","211660","416374","628034","13.3","4.5","402363","603359","200996","12.8","4.3"
"Oklahoma","2004","1171524","62993","20740","1.8","27.6","8482","10.9","6922","8.9","78328","4758","4792","27692","65494","117130","182624","15.6","5.6","111800","161884","50084","13.8","4.3"
"Oregon","2004","1334221","75631","22891","1.7","26.2","11116","12.2","8759","9.6","92243","5788","5798","31602","72832","124804","197636","14.8","5.5","109003","174745","65742","13.1","4.9"
"Pennsylvania","2004","5054253","213608","58386","1.1","25.4","26065","9.6","21872","8.1","272071","14038","14056","115152","227768","472237","700005","13.8","4.5","408198","641619","233421","12.7","4.6"
"Rhode Island","2004","425119","22957","14629","3.5","22.2","2960","11.4","2141","8.3","26308","1450","1451","8989","19763","42161","61924","14.6","4.6","31779","47295","15516","11.1","3.6"
"South Carolina","2004","1530224","71160","17181","1.1","27.6","10368","11.6","8021","8.9","90634","5482","5483","35909","85524","143166","228690","14.9","5.6","141542","211509","69967","13.8","4.6"
"South Dakota","2004","297732","18550","9295","3.2","23.6","2284","10.5","1810","8.3","21933","1212","1212","6461","14061","30456","44517","15.0","4.7","22196","35222","13026","11.8","4.4"
"Tennessee","2004","2303377","90970","60753","2.6","25.4","13153","11.1","10513","8.8","120055","7068","7085","49787","124063","228556","352619","15.3","5.4","192553","291866","99313","12.7","4.3"
"Texas","2004","7951949","333499","156251","1.9","30.8","53806","12.4","43807","10.1","439327","29471","29559","215391","552369","825600","1377969","17.3","6.9","790251","1221718","431467","15.4","5.4"
"Utah","2004","917082","43504","48780","5.4","27.6","7976","15.4","5685","11.0","52689","3661","3662","23687","64177","111530","175707","19.2","7.0","82616","126927","44311","13.8","4.8"
"Vermont","2004","254759","16846","-545","-0.2","22.4","1910","9.9","1526","7.9","19428","989","989","5101","10113","18371","28484","11.2","4.0","20408","29029","8621","11.4","3.4"
"Virginia","2004","2946653","130500","131806","4.5","24.4","19757","12.0","13858","8.4","167869","8906","8925","59257","169287","323055","492342","16.7","5.7","246180","360536","114356","12.2","3.9"
"Washington","2004","2220614","121553","68062","3.1","26.0","18789","12.8","14670","10.0","148614","9700","9707","52073","130621","227229","357850","16.1","5.9","197312","289788","92476","13.0","4.2"
"West Virginia","2004","555586","29277","10506","1.9","23.2","3608","9.8","3007","8.2","36990","2058","2076","11217","23635","51465","75100","13.5","4.3","45129","64594","19465","11.6","3.5"
"Wisconsin","2004","2394019","102322","65542","2.7","22.0","12238","9.6","9919","7.8","128176","6469","6505","42359","112091","216039","328130","13.7","4.7","178059","262588","84529","11.0","3.5"
"Wyoming","2004","180378","14522","8260","4.6","24.8","1974","11.9","1549","9.3","16761","998","998","4429","10355","20290","30645","17.0","5.7","14817","22385","7568","12.4","4.2"
"Alabama","2005","1631579","71912","55740","3.4","26.8","10115","11.0","7823","8.5","93111","5581","5598","37789","94471","179105","273576","16.8","5.8","153218","217836","64618","13.4","4.0"
"Alaska","2005","226102","13471","7297","3.2","25.6","1989","12.3","1489","9.2","16436","954","954","4564","11233","24897","36130","16.0","5.0","21549","28833","7284","12.8","3.2"
"Arizona","2005","2069130","88023","139766","6.7","27.4","16546","15.0","10455","9.5","112792","7203","7207","54239","174605","248386","422991","20.4","8.4","186645","283225","96580","13.7","4.7"
"Arkansas","2005","1001337","47064","22696","2.3","23.8","6640","11.3","5192","8.8","59357","3909","3915","24263","52579","89725","142304","14.2","5.3","81857","119608","37751","11.9","3.8"
"California","2005","13052191","605273","249908","1.9","29.6","101138","13.7","74499","10.1","751942","52690","52838","386688","854824","1325584","2180408","16.7","6.5","1293096","1930500","637404","14.8","4.9"
"Colorado","2005","1892777","105962","47740","2.5","28.6","18113","14.3","13156","10.4","128910","8689","8721","60685","131535","186287","317822","16.8","6.9","170501","270082","99581","14.3","5.3"
"Connecticut","2005","1518199","68836","7008","0.4","27.2","8673","10.5","7104","8.6","83631","4581","4584","35113","95135","117591","212726","14.0","6.3","129830","205718","75888","13.6","5.0"
"Delaware","2005","387117","18337","3862","1.0","27.2","2507","11.2","2172","9.7","22486","1277","1280","9911","20713","35682","56395","14.6","5.4","30540","52533","21993","13.6","5.7"
"District of Columbia","2005","440088","15363","9790","2.2","22.2","2420","13.1","1399","7.6","18966","765","771","4963","22051","36639","58690","13.3","5.0","36534","48900","12366","11.1","2.8"
"Florida","2005","6580273","350111","272913","4.2","31.4","69028","16.4","45090","10.7","430317","31495","31606","245309","564985","743600","1308585","19.9","8.6","646405","1035672","389267","15.7","5.9"
"Geogia","2005","3431017","151220","75671","2.2","28.4","25803","13.6","18319","9.6","193210","12446","12459","94906","222054","340137","562191","16.4","6.5","323285","486520","163235","14.2","4.8"
"Hawaii","2005","479279","23342","17467","3.7","23.4","3022","10.5","2163","7.5","29218","1488","1513","11864","29524","44105","73629","15.4","6.2","37899","56162","18263","11.7","3.8"
"Idaho","2005","498015","31202","29307","5.9","26.2","5447","15.1","3256","9.0","37008","2211","2213","13245","40162","54557","94719","19.0","8.1","39899","65412","25513","13.1","5.1"
"Illinois","2005","5206469","225231","40421","0.8","26.8","31443","11.3","24906","9.0","280786","15895","15939","119666","281928","456901","738829","14.2","5.4","481578","698408","216830","13.4","4.2"
"Indiana","2005","2581586","104070","40263","1.6","24.4","13520","10.0","11318","8.4","135432","7695","7731","58069","136039","219611","355650","13.8","5.3","220257","315387","95130","12.2","3.7"
"Iowa","2005","1240617","58095","24322","2.0","21.0","6891","9.4","5678","7.8","73657","3895","3915","23536","51552","103500","155052","12.5","4.2","91893","130730","38837","10.5","3.1"
"Kansas","2005","1107069","54925","15414","1.4","25.6","7110","10.4","5647","8.3","68722","3950","3961","22931","59516","97300","156816","14.2","5.4","92328","141402","49074","12.8","4.4"
"Kentucky","2005","1494006","65155","26842","1.8","25.8","8675","10.4","6993","8.4","83888","4976","4997","34179","76880","142360","219240","14.7","5.1","137815","192398","54583","12.9","3.7"
"Louisiana","2005","1591094","74343","8946","0.5","30.0","9481","10.1","7988","8.5","94119","5661","5682","46805","87349","159704","247053","15.5","5.5","156404","238107","81703","15.0","5.1"
"Maine","2005","487321","30029","7490","1.5","23.0","3942","11.1","3049","8.6","36035","2028","2030","10046","23141","40390","63531","13.0","4.7","39678","56041","16363","11.5","3.4"
"Maryland","2005","2136365","98925","26380","1.3","26.6","14356","11.9","10671","8.8","122494","6888","6912","47335","116536","194948","311484","14.6","5.5","192921","285104","92183","13.3","4.3"
"Massachusetts","2005","2965989","126867","37473","1.3","23.8","16184","10.4","14538","9.3","156237","9994","10016","59204","142639","247867","390506","13.2","4.8","238312","353033","114721","11.9","3.9"
"Michigan","2005","3783823","166027","-78534","-2.0","27.0","21973","10.6","19009","9.1","208880","12432","12501","98464","203619","305641","509260","13.5","5.4","424349","587794","163445","15.5","4.3"
"Minnesota","2005","2396825","104632","60483","2.6","23.4","14093","11.0","10955","8.5","129977","7009","7015","46889","129092","212554","341646","14.3","5.4","195775","281163","85388","11.7","3.6"
"Mississippi","2005","917686","43151","6644","0.8","27.0","5953","10.8","4977","9.1","55247","3568","3581","24395","50186","80654","130840","14.3","5.5","85780","124196","38416","13.5","4.2"
"Missouri","2005","2392461","109890","22265","1.0","25.8","16834","12.3","12655","9.3","138449","9065","9077","62935","134550","197453","332003","13.9","5.6","214453","309738","95285","12.9","4.0"
"Montana","2005","316337","26175","10181","3.2","24.4","3842","12.9","2657","8.9","30376","1817","1823","7710","19764","29063","48827","15.4","6.2","27066","38646","11580","12.2","3.7"
"Nebraska","2005","769377","37553","5874","0.7","26.2","4504","9.8","3551","7.7","46300","2438","2448","15097","35439","71068","106507","13.8","4.6","75379","100633","25254","13.1","3.3"
"Nevada","2005","1042919","39944","65505","6.3","27.4","8322","17.3","5386","11.2","49397","3865","3867","35349","81571","126776","208347","20.0","7.8","80913","142842","61929","13.7","5.9"
"New Hampshire","2005","541897","28956","13486","2.5","22.2","3939","11.5","3045","8.9","34769","2140","2141","13077","30351","43504","73855","13.6","5.6","40341","60369","20028","11.1","3.7"
"New Jersey","2005","3553499","180091","-2771","-0.1","29.0","25604","12.2","21021","10.0","212238","14356","14368","95454","197025","318293","515318","14.5","5.5","336463","518089","181626","14.6","5.1"
"New Mexico","2005","581465","32438","17610","3.0","28.0","4672","11.8","3492","8.8","40056","2396","2406","15245","35146","63700","98846","17.0","6.0","57121","81236","24115","14.0","4.1"
"New York","2005","7375824","384163","54490","0.7","27.4","53326","11.9","45516","10.1","451631","30952","30992","197576","422126","640336","1062462","14.4","5.7","667872","1007972","340100","13.7","4.6"
"North Carolina","2005","3359538","151442","82769","2.5","26.8","23281","12.2","16842","8.8","193993","11606","11645","77305","211759","322407","534166","15.9","6.3","315876","451397","135521","13.4","4.0"
"North Dakota","2005","265229","15462","8328","3.2","21.6","1820","9.8","1393","7.5","18736","913","913","4456","13826","23255","37081","14.0","5.2","18561","28753","10192","10.8","3.8"
"Ohio","2005","4726960","186389","35939","0.8","26.6","23518","9.6","20405","8.3","246001","13457","13490","108152","248028","417561","665589","14.1","5.2","436430","629650","193220","13.3","4.1"
"Oklahoma","2005","1192297","63843","26763","2.3","26.8","9062","11.5","6982","8.9","79697","5008","5017","35698","74331","112360","186691","15.7","6.2","102484","159928","57444","13.4","4.8"
"Oregon","2005","1369622","78290","65554","4.8","23.2","12411","13.3","8535","9.1","95360","5748","5753","34001","89629","135178","224807","16.4","6.5","102324","159253","56929","11.6","4.2"
"Pennsylvania","2005","5062801","215632","16181","0.3","26.0","27814","10.2","22469","8.2","275372","14870","14917","110175","260419","411628","672047","13.3","5.1","440489","655866","215377","13.0","4.3"
"Rhode Island","2005","433121","23166","6307","1.5","22.8","2917","11.0","2399","9.1","26675","1624","1624","9942","21819","33871","55690","12.9","5.0","34526","49383","14857","11.4","3.4"
"South Carolina","2005","1551434","72961","44656","2.8","25.4","11257","12.3","7976","8.7","93164","5710","5723","35455","94590","146500","241090","15.5","6.1","139172","196434","57262","12.7","3.7"
"South Dakota","2005","304208","18890","7573","2.4","22.6","2371","10.7","1802","8.2","22338","1217","1217","5730","13486","28321","41807","13.7","4.4","23766","34234","10468","11.3","3.4"
"Tennessee","2005","2341395","92051","46044","2.0","26.4","13659","11.3","10705","8.9","121869","7507","7520","53794","126515","228413","354928","15.2","5.4","215704","308884","93180","13.2","4.0"
"Texas","2005","8097394","339128","236225","2.9","29.0","56076","12.7","42154","9.5","448680","29533","29652","239955","582885","824097","1406982","17.4","7.2","777661","1170757","393096","14.5","4.9"
"Utah","2005","954056","45597","37724","4.0","29.8","8635","16.1","5716","10.6","55091","3773","3783","28465","67925","111997","179922","18.9","7.1","92638","142198","49560","14.9","5.2"
"Vermont","2005","256746","16982","6940","2.7","22.2","1923","9.9","1617","8.3","19618","1093","1096","6060","11602","23933","35535","13.8","4.5","18911","28595","9684","11.1","3.8"
"Virginia","2005","3018187","134080","53836","1.8","26.8","20636","12.2","14589","8.6","172304","9668","9719","57677","176325","281677","458002","15.2","5.8","291588","404166","112578","13.4","3.7"
"Washington","2005","2275844","125549","68385","3.0","26.6","20816","13.8","14657","9.7","153434","9939","9944","60143","141270","229889","371159","16.3","6.2","195881","302774","106893","13.3","4.7"
"West Virginia","2005","561025","29409","4927","0.9","25.8","3867","10.4","3194","8.6","37336","2213","2217","11307","27024","50203","77227","13.8","4.8","51255","72300","21045","12.9","3.8"
"Wisconsin","2005","2430833","103727","30468","1.3","23.6","12905","10.0","10086","7.8","130102","6877","6916","48367","110272","207680","317952","13.1","4.5","198439","287484","89045","11.8","3.7"
"Wyoming","2005","187032","14928","4502","2.4","27.8","2173","12.8","1520","8.9","17291","1067","1067","5437","11353","19163","30516","16.3","6.1","18051","26014","7963","13.9","4.3"
"Alabama","2006","1676746","71954","50054","3.0","26.6","10453","11.2","8535","9.1","94127","5906","5931","42249","108950","163658","272608","16.3","6.5","142479","222554","80075","13.3","4.8"
"Alaska","2006","233553","13514","10818","4.6","26.2","2145","13.0","1738","10.5","16695","1069","1069","5605","12061","29343","41404","17.7","5.2","20243","30586","10343","13.1","4.4"
"Arizona","2006","2222118","92344","187345","8.5","24.2","18941","16.4","11445","9.9","119297","7755","7780","54014","179957","277100","457057","20.6","8.1","177125","269712","92587","12.1","4.2"
"Arkansas","2006","1024168","47017","34606","3.3","22.8","7008","11.8","5708","9.6","60099","4114","4130","25150","58025","92840","150865","14.7","5.7","78727","116259","37532","11.4","3.7"
"California","2006","13386120","617167","569403","4.3","27.2","104928","13.8","79912","10.5","770688","55919","56079","397172","921350","1473240","2394590","17.9","6.9","1185085","1825187","640102","13.6","4.8"
"Colorado","2006","1950075","107962","93001","4.8","26.6","18625","14.3","14228","10.9","131989","9292","9310","60508","142727","210138","352865","18.1","7.3","161679","259864","98185","13.3","5.0"
"Connecticut","2006","1531126","68481","34519","2.3","23.0","8612","10.3","7724","9.2","83902","5304","5306","35642","76552","134105","210657","13.8","5.0","116340","176138","59798","11.5","3.9"
"Delaware","2006","384702","18167","-4928","-1.3","29.2","2553","11.4","2412","10.8","22422","1493","1509","9499","21131","35174","56305","14.6","5.5","36547","61233","24686","15.9","6.4"
"District of Columbia","2006","446359","15582","8721","2.0","25.6","2091","10.9","1527","8.0","19355","883","889","7106","20219","45852","66071","14.8","4.5","42362","57350","14988","12.8","3.4"
"Florida","2006","6902110","360894","427663","6.2","26.8","67750","15.5","49324","11.3","444343","34326","34386","217924","510172","841661","1351833","19.6","7.4","566387","924170","357783","13.4","5.2"
"Geogia","2006","3525491","154619","153665","4.4","26.4","26474","13.6","19790","10.1","198160","13152","13168","98618","247547","373017","620564","17.6","7.0","292548","466899","174351","13.2","4.9"
"Hawaii","2006","498357","23743","24134","4.8","21.6","3293","11.1","2258","7.6","30034","1540","1540","10434","29064","48832","77896","15.6","5.8","35971","53762","17791","10.8","3.6"
"Idaho","2006","526510","32972","32653","6.2","25.2","6128","16.1","3879","10.2","39067","2571","2573","18990","37401","61368","98769","18.8","7.1","38799","66116","27317","12.6","5.2"
"Illinois","2006","5273257","226308","141178","2.6","25.4","31767","11.3","26528","9.4","283645","16825","16856","133372","297894","510637","808531","15.3","5.6","420474","667353","246879","12.7","4.7"
"Indiana","2006","2626291","104308","71646","2.7","23.8","14591","10.7","12079","8.9","136925","7765","7798","60653","141904","242193","384097","14.6","5.4","209847","312451","102604","11.9","3.9"
"Iowa","2006","1268988","57538","38033","2.9","21.2","7748","10.5","6623","9.0","74149","4109","4109","27432","65542","106389","171931","13.5","5.2","91454","133898","42444","10.6","3.3"
"Kansas","2006","1120068","54519","25899","2.3","24.0","7293","10.6","6604","9.6","68823","4233","4256","26678","58763","101964","160727","14.3","5.2","89470","134828","45358","12.0","4.0"
"Kentucky","2006","1515778","65039","40183","2.6","24.6","8851","10.5","7512","8.9","84574","5190","5194","41128","81378","144638","226016","14.9","5.4","120888","185833","64945","12.3","4.3"
"Louisiana","2006","1572744","70851","-11959","-0.7","35.0","9927","10.8","11567","12.5","90863","7253","7259","51744","99278","175316","274594","17.5","6.3","191127","286553","95426","18.2","6.1"
"Maine","2006","493834","30147","11723","2.3","23.6","4229","11.7","3533","9.8","36448","2417","2422","14079","29962","39849","69811","14.1","6.1","36375","58088","21713","11.8","4.4"
"Maryland","2006","2179281","100089","77670","3.6","25.0","14684","11.9","11418","9.3","124696","7530","7547","51587","127905","222084","349989","16.1","5.9","174608","272319","97711","12.5","4.5"
"Massachusetts","2006","3012055","127517","83769","2.8","24.2","16948","10.8","13974","8.9","157968","9313","9320","66825","167204","281361","448565","14.9","5.6","242349","364796","122447","12.1","4.1"
"Michigan","2006","3746234","164697","51678","1.4","26.4","21887","10.5","20103","9.6","209042","13450","13486","91161","197310","350469","547779","14.6","5.3","340264","496101","155837","13.2","4.2"
"Minnesota","2006","2446297","105141","63993","2.6","24.0","15152","11.6","12127","9.3","131841","7604","7613","56714","130076","227415","357491","14.6","5.3","191880","293498","101618","12.0","4.2"
"Mississippi","2006","925700","42378","19435","2.1","27.4","6072","11.1","5920","10.8","54740","3932","3937","25709","56744","89916","146660","15.8","6.1","85061","127225","42164","13.7","4.6"
"Missouri","2006","2416727","108081","53033","2.2","25.6","16145","11.7","15286","11.1","138051","10613","10657","63802","139368","223336","362704","15.0","5.8","201441","309671","108230","12.8","4.5"
"Montana","2006","328718","27004","17969","5.4","25.8","4337","14.1","3079","10.0","31409","2009","2009","11297","25660","34651","60311","18.3","7.8","25624","42342","16718","12.9","5.1"
"Nebraska","2006","778278","37422","21041","2.7","22.4","4789","10.3","4168","9.0","46581","2589","2596","16806","42467","65431","107898","13.9","5.5","59733","86857","27124","11.2","3.5"
"Nevada","2006","1113346","41777","85803","7.7","26.0","8910","17.6","5851","11.6","52023","4160","4163","33483","93095","137066","230161","20.7","8.4","92298","144358","52060","13.0","4.7"
"New Hampshire","2006","554098","28965","17316","3.1","24.8","3952","11.3","3388","9.7","35037","2342","2343","14464","32360","53572","85932","15.5","5.8","44430","68616","24186","12.4","4.4"
"New Jersey","2006","3566348","180875","73326","2.1","26.8","25502","12.0","21916","10.3","214051","15420","15434","89555","209624","342954","552578","15.5","5.9","312781","479252","166471","13.4","4.7"
"New Mexico","2006","604139","32912","35626","5.9","25.0","5040","12.5","3898","9.7","40842","2614","2619","18882","41252","70073","111325","18.4","6.8","46298","75699","29401","12.5","4.9"
"New York","2006","7431798","384889","129468","1.7","25.8","53955","11.9","47184","10.4","455004","34251","34297","219234","400454","686993","1087447","14.6","5.4","616384","957979","341595","12.9","4.6"
"North Carolina","2006","3448872","153588","137634","4.0","25.2","24326","12.4","18257","9.3","198335","12490","12513","86009","222664","349295","571959","16.6","6.5","280713","434325","153612","12.6","4.5"
"North Dakota","2006","272642","15382","9165","3.4","21.8","1947","10.4","1674","8.9","18823","1000","1000","6550","13915","25031","38946","14.3","5.1","19013","29781","10768","10.9","3.9"
"Ohio","2006","4756346","184406","86522","1.8","25.0","24058","9.8","22182","9.0","245668","14293","14372","113689","254924","424410","679334","14.3","5.4","384597","592812","208215","12.5","4.4"
"Oklahoma","2006","1234952","64105","78677","6.4","23.8","9227","11.5","7578","9.5","80532","5167","5197","32379","91281","134734","226015","18.3","7.4","92750","147338","54588","11.9","4.4"
"Oregon","2006","1423618","79765","54817","3.8","25.0","12706","13.2","9432","9.8","97777","6508","6508","42900","86580","145634","232214","16.3","6.1","114207","177397","63190","12.5","4.4"
"Pennsylvania","2006","5099144","214383","110224","2.2","23.2","27512","10.0","24024","8.7","276494","16148","16321","130080","265615","436299","701914","13.8","5.2","382484","591690","209206","11.6","4.1"
"Rhode Island","2006","435260","23301","3009","0.7","26.6","3077","11.5","2542","9.5","26983","1724","1729","9423","23511","37304","60815","14.0","5.4","40818","57806","16988","13.3","3.9"
"South Carolina","2006","1594154","73888","59992","3.8","24.4","11278","12.0","8772","9.4","94865","6003","6013","40476","97591","157296","254887","16.0","6.1","128885","194895","66010","12.2","4.1"
"South Dakota","2006","312906","18911","12215","3.9","21.2","2472","11.1","2169","9.7","22459","1366","1367","7775","16249","29163","45412","14.5","5.2","21648","33197","11549","10.6","3.7"
"Tennessee","2006","2406681","92440","109226","4.5","23.4","14215","11.6","11590","9.5","123358","7645","7672","50756","147819","242629","390448","16.2","6.1","187654","281222","93568","11.7","3.9"
"Texas","2006","8369291","342461","428335","5.1","26.6","57906","12.8","44996","10.0","457285","30260","30359","233183","585359","953422","1538781","18.4","7.0","702331","1110446","408115","13.3","4.9"
"Utah","2006","1001326","47950","65942","6.6","25.0","9500","16.8","6005","10.6","58046","4045","4087","28691","73634","117125","190759","19.1","7.4","77990","124817","46827","12.5","4.7"
"Vermont","2006","260639","16957","2737","1.1","22.2","1975","10.1","1781","9.1","19687","1214","1220","6471","10922","20845","31767","12.2","4.2","19591","29030","9439","11.1","3.6"
"Virginia","2006","3086766","136452","130801","4.3","24.8","21841","12.5","15869","9.1","176674","10672","10686","68733","185777","328765","514542","16.7","6.0","256758","383741","126983","12.4","4.1"
"Washington","2006","2349985","128042","102439","4.4","25.8","21238","13.7","16209","10.5","157132","10929","10934","64051","147470","258660","406130","17.3","6.3","200579","303691","103112","12.9","4.4"
"West Virginia","2006","570120","28947","18892","3.3","24.0","3705","10.0","3567","9.6","37112","2350","2357","13822","32759","54488","87247","15.3","5.7","45109","68355","23246","12.0","4.1"
"Wisconsin","2006","2450218","103092","37585","1.5","23.4","13345","10.3","11745","9.0","130620","7666","7672","55493","119501","204458","323959","13.2","4.9","197510","286374","88864","11.7","3.6"
"Wyoming","2006","195009","15210","13876","7.1","24.2","2279","13.1","1783","10.2","17627","1162","1166","6251","14712","22781","37493","19.2","7.5","14594","23617","9023","12.1","4.6"
"Alabama","2007","1706364","73242","23610","1.4","29.4","11089","11.6","8667","9.1","96526","5596","5685","37094","102861","172408","275269","16.1","6.0","170772","251659","80887","14.7","4.7"
"Alaska","2007","240306","13656","3228","1.3","34.2","2033","12.1","1837","10.9","16934","1028","1039","4935","15457","28790","44247","18.4","6.4","29981","41019","11038","17.1","4.6"
"Arizona","2007","2340144","95367","68641","2.9","34.2","18072","14.9","13330","11.0","123760","8323","8391","63389","165632","302881","468513","20.0","7.1","267026","399872","132846","17.1","5.7"
"Arkansas","2007","1033247","47399","-5736","-0.5","29.4","6730","11.1","5641","9.3","61033","3791","3811","22436","55680","95869","151549","14.7","5.4","111142","157285","46143","15.2","4.5"
"California","2007","13659650","627092","97028","0.7","32.4","101437","13.1","86040","11.1","783091","54998","55593","355710","837847","1473827","2311674","16.9","6.1","1469050","2214646","745596","16.2","5.5"
"Colorado","2007","2012974","110326","54391","2.7","31.8","18667","14.0","14993","11.2","135328","9137","9200","56408","147975","226202","374177","18.6","7.4","207715","319786","112071","15.9","5.6"
"Connecticut","2007","1540987","68225","-7646","-0.5","29.4","8369","10.0","7863","9.4","84190","4892","4944","30111","83115","142822","225937","14.7","5.4","168316","233583","65267","15.2","4.2"
"Delaware","2007","381877","18036","1747","0.5","35.2","2694","12.0","2422","10.8","22635","1393","1395","9682","31164","37807","68971","18.1","8.2","41995","67224","25229","17.6","6.6"
"District of Columbia","2007","458077","15704","17337","3.8","25.6","2141","11.0","1779","9.1","19667","935","939","7362","23757","52109","75866","16.6","5.2","39153","58529","19376","12.8","4.2"
"Florida","2007","7087465","365813","2255","0.0","35.6","65417","14.6","55431","12.4","452973","37329","37612","211527","510170","754843","1265013","17.8","7.2","810887","1262758","451871","17.8","6.4"
"Geogia","2007","3616624","158478","58216","1.6","30.8","27198","13.5","20972","10.4","203958","13325","13539","87990","234317","381621","615938","17.0","6.5","372010","557722","185712","15.4","5.1"
"Hawaii","2007","512997","24062","8507","1.6","28.6","3176","10.5","2804","9.3","30378","1636","1657","14245","27973","53736","81709","15.9","5.5","43832","73202","29370","14.3","5.7"
"Idaho","2007","543932","34460","4411","0.8","35.2","6021","15.1","4147","10.4","40908","2728","2741","18595","39109","61142","100251","18.4","7.2","64878","95840","30962","17.6","5.7"
"Illinois","2007","5345845","228146","32379","0.6","29.2","31264","11.0","27332","9.6","287053","16305","16473","118854","280871","533272","814143","15.2","5.3","530757","781764","251007","14.6","4.7"
"Indiana","2007","2645792","104775","-7539","-0.3","29.6","14395","10.5","12725","9.3","138369","7852","7954","55931","136204","254830","391034","14.8","5.1","278555","398573","120018","15.1","4.5"
"Iowa","2007","1288325","57836","6082","0.5","25.6","6890","9.3","6283","8.5","74693","3791","3833","23021","54137","117015","171152","13.3","4.2","115342","165070","49728","12.8","3.9"
"Kansas","2007","1137885","54909","22699","2.0","26.6","7297","10.6","6490","9.4","69528","4003","4045","24045","67231","106450","173681","15.3","5.9","102787","150982","48195","13.3","4.2"
"Kentucky","2007","1534537","65233","10825","0.7","29.2","8789","10.4","7737","9.1","85368","4947","4997","33849","87436","147754","235190","15.3","5.7","160898","224365","63467","14.6","4.1"
"Louisiana","2007","1596659","74096","69814","4.4","28.6","11565","12.5","7861","8.5","94831","4881","4930","34515","101143","197306","298449","18.7","6.3","161483","228635","67152","14.3","4.2"
"Maine","2007","497728","30297","-32","0.0","29.4","4064","11.1","3607","9.8","36884","2216","2225","13935","28961","44343","73304","14.7","5.8","46369","73336","26967","14.7","5.4"
"Maryland","2007","2211202","100821","4094","0.2","30.2","14143","11.3","12484","10.0","126012","7541","7604","47227","120251","217363","337614","15.3","5.4","229199","333520","104321","15.1","4.7"
"Massachusetts","2007","3059532","127388","16004","0.6","27.0","15895","10.1","15206","9.6","158399","9079","9189","54890","132276","297680","429956","14.1","4.3","285760","413952","128192","13.5","4.2"
"Michigan","2007","3707476","163318","-88089","-2.3","28.2","21334","10.2","21593","10.4","208325","13324","13556","87461","188692","332821","521513","14.1","5.1","406266","609602","203336","16.4","5.5"
"Minnesota","2007","2499732","105321","62853","2.5","26.6","14128","10.7","13300","10.1","132381","7473","7528","50542","135793","260285","396078","15.8","5.4","222903","333225","110322","13.3","4.4"
"Mississippi","2007","934203","43366","2648","0.3","29.2","6511","11.7","5085","9.2","56272","3320","3343","18920","47866","91377","139243","14.9","5.1","95935","136595","40660","14.6","4.4"
"Missouri","2007","2445373","108071","23504","0.9","28.0","15513","11.2","14104","10.2","139117","9267","9383","52352","127368","237951","365319","14.9","5.2","237292","341815","104523","14.0","4.3"
"Montana","2007","344261","27856","14093","4.1","28.2","4113","12.9","3045","9.5","32425","1931","1954","9126","22043","40465","62508","18.2","6.4","32749","48415","15666","14.1","4.6"
"Nebraska","2007","789475","37642","8619","1.0","26.0","4667","10.0","4077","8.7","47102","2492","2500","15152","37584","73278","110862","14.0","4.8","72581","102243","29662","13.0","3.8"
"Nevada","2007","1167862","43089","42994","3.7","33.0","8770","16.6","6645","12.5","54021","4383","4406","30457","92579","143603","236182","20.2","7.9","132277","193188","60911","16.5","5.2"
"New Hampshire","2007","562318","28918","2735","0.5","27.4","3770","10.7","3484","9.9","35212","2233","2244","13035","26782","52954","79736","14.2","4.8","54218","77001","22783","13.7","4.1"
"New Jersey","2007","3610285","180965","33040","1.0","29.6","24482","11.4","23253","10.9","214977","15300","15366","84378","204154","364499","568653","15.8","5.7","359089","535613","176524","14.8","4.9"
"New Mexico","2007","630024","33451","19063","3.1","30.6","4908","11.9","3935","9.5","41765","2469","2491","14656","49000","66614","115614","18.4","7.8","68159","96551","28392","15.3","4.5"
"New York","2007","7499186","387203","43027","0.6","28.6","52189","11.4","47542","10.4","458493","31816","32022","183250","399094","719290","1118384","14.9","5.3","695397","1075357","379960","14.3","5.1"
"North Carolina","2007","3539610","157050","74690","2.2","29.0","25057","12.5","19291","9.6","203768","12116","12278","79195","214550","374803","589353","16.7","6.1","349978","514663","164685","14.5","4.7"
"North Dakota","2007","283220","15645","9408","3.3","25.8","1923","10.1","1603","8.4","19170","912","923","6852","17774","28104","45878","16.2","6.3","24963","36470","11507","12.9","4.1"
"Ohio","2007","4776490","182916","-3928","-0.1","28.4","23946","9.8","23300","9.5","245813","13776","14011","99005","248663","429840","678503","14.2","5.2","471673","682431","210758","14.3","4.4"
"Oklahoma","2007","1282434","65032","29012","2.3","30.0","9383","11.5","7571","9.3","82232","4940","4986","32392","77023","144494","221517","17.3","6.0","130837","192505","61668","15.0","4.8"
"Oregon","2007","1458850","81717","25148","1.7","28.0","12340","12.5","9682","9.8","100301","6164","6235","33884","81241","148299","229540","15.7","5.6","138846","204392","65546","14.0","4.5"
"Pennsylvania","2007","5161012","214521","56708","1.1","26.4","27097","9.8","24983","9.0","277520","14727","14926","91845","252168","484415","736583","14.3","4.9","460681","679875","219194","13.2","4.2"
"Rhode Island","2007","438139","23132","6365","1.4","25.6","2734","10.1","2715","10.1","26964","1748","1763","10314","20693","41641","62334","14.2","4.7","38338","55969","17631","12.8","4.0"
"South Carolina","2007","1626298","75140","26958","1.7","30.0","11744","12.2","9114","9.5","97362","6035","6123","38306","103032","168221","271253","16.7","6.3","168767","244295","75528","15.0","4.6"
"South Dakota","2007","321366","19196","6299","2.0","26.0","2471","10.9","1994","8.8","22911","1229","1233","7420","17987","30071","48058","15.0","5.6","27631","41759","14128","13.0","4.4"
"Tennessee","2007","2470788","93687","34466","1.4","30.4","14394","11.6","11806","9.5","125759","7401","7498","50216","137346","273902","411248","16.6","5.6","259738","376782","117044","15.2","4.7"
"Texas","2007","8726014","349591","365173","4.2","30.6","60291","13.0","46691","10.1","469229","29483","29838","219750","635983","1062424","1698407","19.5","7.3","863674","1333234","469560","15.3","5.4"
"Utah","2007","1057626","50829","57469","5.4","28.2","9676","16.2","6319","10.6","61337","4008","4026","26435","70275","136319","206594","19.5","6.6","97209","149125","51916","14.1","4.9"
"Vermont","2007","266249","17094","9122","3.4","24.8","2029","10.3","1861","9.4","19849","1088","1096","5047","13145","28944","42089","15.8","4.9","22262","32967","10705","12.4","4.0"
"Virginia","2007","3145819","138162","12840","0.4","32.0","21084","11.8","17544","9.9","179877","10590","10701","69289","173876","342434","516310","16.4","5.5","345990","503470","157480","16.0","5.0"
"Washington","2007","2439719","131402","92606","3.8","27.6","21222","13.3","16810","10.6","161294","10561","10630","57595","145357","282864","428221","17.6","6.0","215919","335615","119696","13.8","4.9"
"West Virginia","2007","578025","28886","487","0.1","29.4","3600","9.7","3416","9.2","37304","2163","2202","14133","32272","53399","85671","14.8","5.6","59318","85184","25866","14.7","4.5"
"Wisconsin","2007","2470623","103199","17183","0.7","25.0","12957","9.9","11947","9.1","131286","7085","7162","44412","111864","215104","326968","13.2","4.5","218869","309785","90916","12.5","3.7"
"Wyoming","2007","205331","15690","9297","4.5","28.2","2331","13.0","1691","9.4","18238","1102","1110","5347","12920","25360","38280","18.6","6.3","18654","28983","10329","14.1","5.0"
"Alabama","2008","1706236","72666","8085","0.5","26.6","8962","9.3","8375","8.7","96133","6228","6235","40904","78618","157099","235717","13.8","4.6","155255","227632","72377","13.3","4.2"
"Alaska","2008","243073","13600","5546","2.3","25.0","1859","11.0","1731","10.3","16897","1055","1056","5020","11169","24773","35942","14.8","4.6","23027","30396","7369","12.5","3.0"
"Arizona","2008","2329160","94692","-50896","-2.2","30.6","15715","12.7","14298","11.6","123829","10222","10249","71871","143226","214253","357479","15.3","6.1","293954","408375","114421","17.5","4.9"
"Arkansas","2008","1022270","46963","1075","0.1","24.8","5688","9.4","5412","8.9","60728","3979","3989","22908","44767","82766","127533","12.5","4.4","92928","126458","33530","12.4","3.3"
"California","2008","13636472","623470","45609","0.4","30.0","89808","11.5","83640","10.7","781622","59625","59738","415529","760834","1332441","2093275","15.4","5.6","1397705","2047666","649961","15.0","4.8"
"Colorado","2008","2051948","110706","48204","2.3","28.4","16802","12.4","14839","11.0","136128","9818","9833","57149","123614","215637","339251","16.5","6.0","192373","291047","98674","14.2","4.8"
"Connecticut","2008","1540645","67748","27329","1.8","26.6","7693","9.2","7214","8.6","84082","4936","4937","31159","83030","149035","232065","15.1","5.4","149189","204736","55547","13.3","3.6"
"Delaware","2008","383273","17863","5887","1.5","28.6","2320","10.3","2255","10.0","22492","1536","1536","7615","21986","38664","60650","15.8","5.7","41528","54763","13235","14.3","3.5"
"District of Columbia","2008","469428","15692","11326","2.4","22.0","1968","10.0","1584","8.1","19763","917","918","5406","20445","42356","62801","13.4","4.4","36560","51475","14915","11.0","3.2"
"Florida","2008","6996652","356383","-82400","-1.1","31.0","55755","12.5","59285","13.3","444842","43639","43737","238360","436135","644925","1081060","15.5","6.2","791259","1163460","372201","16.6","5.3"
"Geogia","2008","3617140","157375","6673","0.2","31.4","24133","11.9","22238","11.0","203885","15827","15838","102339","229777","343567","573344","15.9","6.4","369482","566671","197189","15.7","5.5"
"Hawaii","2008","513837","23717","1388","0.3","24.8","2689","8.9","2602","8.6","30128","1847","1849","11532","22223","42881","65104","12.7","4.3","46414","63716","17302","12.4","3.4"
"Idaho","2008","539087","33945","-7196","-1.3","28.2","4850","11.9","4694","11.5","40649","3318","3333","19039","29055","46830","75885","14.1","5.4","56711","83081","26370","15.4","4.9"
"Illinois","2008","5384046","226514","123158","2.3","24.6","28500","10.0","26448","9.3","286653","17559","17584","110403","262969","521208","784177","14.6","4.9","468151","661019","192868","12.3","3.6"
"Indiana","2008","2615628","103458","-10180","-0.3","25.6","12301","9.0","11995","8.7","137213","8371","8374","60064","109637","224071","333708","12.8","4.2","244051","343888","99837","13.1","3.8"
"Iowa","2008","1294321","57371","22063","1.7","21.8","6104","8.2","5908","8.0","74301","3945","3948","22999","46812","115918","162730","12.6","3.6","100849","140667","39818","10.9","3.1"
"Kansas","2008","1153430","54540","22777","2.0","23.0","6320","9.1","5826","8.4","69315","4079","4083","25341","47419","108029","155448","13.5","4.1","93440","132671","39231","11.5","3.4"
"Kentucky","2008","1541639","64390","23369","1.5","26.0","7540","8.9","7314","8.6","84928","5245","5260","39214","85768","137362","223130","14.5","5.6","140939","199761","58822","13.0","3.8"
"Louisiana","2008","1629772","74463","19035","1.2","27.0","9297","9.8","7724","8.1","95650","5604","5607","40881","78226","161005","239231","14.7","4.8","158713","220196","61483","13.5","3.8"
"Maine","2008","498135","29818","5922","1.2","23.6","3469","9.5","3577","9.8","36453","2362","2363","12756","20837","43867","64704","13.0","4.2","39308","58782","19474","11.8","3.9"
"Maryland","2008","2208003","99512","16692","0.8","26.8","12209","9.8","12017","9.6","124979","8261","8267","51635","105259","207867","313126","14.2","4.8","200138","296434","96296","13.4","4.4"
"Massachusetts","2008","3059151","125940","20576","0.7","24.4","14093","9.0","13769","8.8","157417","9361","9362","57170","130541","263894","394435","12.9","4.3","265986","373859","107873","12.2","3.5"
"Michigan","2008","3625301","159766","-20730","-0.6","28.0","18970","9.2","20189","9.8","205229","13996","14031","113506","180795","328321","509116","14.0","5.0","358287","529846","171559","14.6","4.7"
"Minnesota","2008","2517548","103933","-1602","0.0","26.0","12347","9.4","12170","9.3","131288","7894","7896","54139","115541","210840","326381","13.0","4.6","238898","327983","89085","13.0","3.5"
"Mississippi","2008","935607","43035","11106","1.2","25.4","5366","9.6","4946","8.8","56200","3767","3768","23111","42641","87188","129829","13.9","4.6","82075","118723","36648","12.7","3.9"
"Missouri","2008","2452162","106720","31836","1.3","25.4","13371","9.7","12982","9.4","138276","9328","9336","51347","121905","220235","342140","14.0","5.0","226133","310304","84171","12.7","3.4"
"Montana","2008","352849","27792","7412","2.1","25.4","3505","10.8","3180","9.8","32458","2150","2152","10279","17364","34960","52324","14.8","4.9","30196","44912","14716","12.7","4.2"
"Nebraska","2008","794079","37467","8298","1.1","24.2","4118","8.8","3765","8.0","47090","2513","2513","13956","32907","71837","104744","13.2","4.1","72123","96446","24323","12.1","3.1"
"Nevada","2008","1166838","42952","-27694","-2.3","30.6","7673","14.2","6837","12.7","54299","5140","5147","35134","73980","104017","177997","15.3","6.3","149269","205691","56422","17.6","4.8"
"New Hampshire","2008","570408","28565","21647","3.8","24.4","3251","9.3","3272","9.4","34921","2285","2286","12191","28588","62441","91029","16.0","5.0","50380","69382","19002","12.2","3.3"
"New Jersey","2008","3611772","178769","2498","0.0","28.4","21852","10.2","22223","10.4","213286","16075","16089","92558","190173","323816","513989","14.2","5.3","354110","511491","157381","14.2","4.4"
"New Mexico","2008","635396","33434","6102","1.0","28.0","4388","10.5","3974","9.5","41824","2740","2741","16765","35380","59691","95071","15.0","5.6","62998","88969","25971","14.0","4.1"
"New York","2008","7554581","389295","141611","1.9","25.0","49839","10.9","43955","9.6","461798","31791","31836","196343","389779","697250","1087029","14.4","5.2","640582","945418","304836","12.5","4.0"
"North Carolina","2008","3564766","156461","36156","1.1","26.4","21338","10.5","18713","9.2","204333","13506","13531","84991","182847","325417","508264","14.3","5.1","334931","472108","137177","13.2","3.8"
"North Dakota","2008","290123","15704","6727","2.4","22.2","1684","8.8","1401","7.3","19275","929","931","6858","11143","27885","39028","13.5","3.8","23620","32301","8681","11.1","3.0"
"Ohio","2008","4729480","179209","-28374","-0.6","25.4","19929","8.2","21412","8.8","241853","14400","14429","106697","206401","394178","600579","12.7","4.4","431406","628953","197547","13.3","4.2"
"Oklahoma","2008","1303599","65276","29782","2.3","25.8","8511","10.3","7157","8.7","82984","5183","5192","30666","69189","128876","198065","15.2","5.3","120164","168283","48119","12.9","3.7"
"Oregon","2008","1467173","81599","12191","0.9","25.8","10823","10.8","9755","9.8","100461","6938","6940","37828","68135","133687","201822","13.8","4.6","133601","189631","56030","12.9","3.8"
"Pennsylvania","2008","5192051","213176","79623","1.5","23.2","24575","8.9","21951","7.9","277621","15121","15138","99893","225487","454611","680098","13.1","4.3","430094","600475","170381","11.6","3.3"
"Rhode Island","2008","437349","22775","-3509","-0.8","25.0","2443","9.1","2692","10.1","26583","1775","1777","9430","21238","33419","54657","12.5","4.9","42272","58166","15894","13.3","3.6"
"South Carolina","2008","1636862","74452","19015","1.2","26.4","9699","10.0","8945","9.2","97154","6506","6510","37788","76753","158380","235133","14.4","4.7","158134","216118","57984","13.2","3.5"
"South Dakota","2008","326294","19153","10882","3.3","21.6","2185","9.5","1916","8.4","22996","1360","1364","7540","15576","30456","46032","14.1","4.8","23644","35150","11506","10.8","3.5"
"Tennessee","2008","2478082","93094","14298","0.5","28.2","13042","10.4","11156","8.9","126432","8262","8274","59292","131254","231444","362698","14.6","5.3","258539","348400","89861","14.1","3.6"
"Texas","2008","8960271","352462","247076","2.8","28.6","53790","11.5","43439","9.3","474307","31198","31288","233904","564321","964216","1528537","17.1","6.3","890224","1281461","391237","14.3","4.4"
"Utah","2008","1089904","51292","20080","1.8","29.4","8111","13.2","7035","11.4","61940","4919","4921","32742","56715","123641","180356","16.5","5.2","106542","160276","53734","14.7","4.9"
"Vermont","2008","270929","16857","3290","1.2","21.8","1724","8.8","1801","9.2","19608","1167","1167","6398","11833","21038","32871","12.1","4.4","20245","29581","9336","10.9","3.4"
"Virginia","2008","3138202","137392","13526","0.5","28.2","18346","10.3","17198","9.6","179167","11719","11747","64120","154088","303394","457482","14.6","4.9","314252","443956","129704","14.1","4.1"
"Washington","2008","2490976","131990","38911","1.6","25.8","18980","11.8","16293","10.1","162537","11414","11417","64943","116939","244311","361250","14.5","4.7","221134","322339","101205","12.9","4.1"
"West Virginia","2008","576985","28335","5212","0.9","24.2","2942","8.0","3115","8.4","36906","2296","2296","11841","22237","52913","75150","13.0","3.9","50993","69938","18945","12.1","3.3"
"Wisconsin","2008","2476303","101772","19401","0.8","22.0","11023","8.5","11024","8.5","130290","7453","7504","48839","92929","199751","292680","11.8","3.8","194355","273279","78924","11.0","3.2"
"Wyoming","2008","212960","15787","8135","3.8","28.2","2065","11.3","1786","9.8","18368","1183","1184","5696","13141","25026","38167","17.9","6.2","20480","30032","9552","14.1","4.5"
"Alabama","2009","1649880","70162","-92364","-5.6","21.2","7519","8.0","9425","10.0","93377","6704","6723","36116","65304","109719","175023","10.6","4.0","202128","267387","65259","16.2","4.0"
"Alaska","2009","246886","13338","4256","1.7","28.4","1716","10.2","1793","10.7","16708","1019","1039","5174","12482","26846","39328","15.9","5.1","24436","35072","10636","14.2","4.3"
"Arizona","2009","2190657","89209","-192052","-8.8","24.8","12483","10.4","16725","13.9","117975","11454","11496","68743","114252","157032","271284","12.4","5.2","314489","463336","148847","21.2","6.8"
"Arkansas","2009","992135","45818","-49375","-5.0","21.6","5128","8.6","5798","9.7","59583","4122","4134","23510","41703","65880","107583","10.8","4.2","113993","156958","42965","15.8","4.3"
"California","2009","13152313","603592","-791317","-6.0","24.0","77068","10.0","90213","11.7","760096","62297","62503","369291","617777","955015","1572792","12.0","4.7","1713517","2364109","650592","18.0","4.9"
"Colorado","2009","2015038","107011","-93383","-4.6","25.8","13980","10.5","16450","12.3","132203","10587","10604","63864","100849","158738","259587","12.9","5.0","245742","352970","107228","17.5","5.3"
"Connecticut","2009","1507128","65542","-77277","-5.1","20.4","6257","7.6","7969","9.6","81635","5128","5150","30772","52952","100620","153572","10.2","3.5","174325","230849","56524","15.3","3.8"
"Delaware","2009","375756","17272","-13189","-3.5","24.2","2000","9.1","2362","10.7","21873","1457","1459","7739","20950","24523","45473","12.1","5.6","42911","58662","15751","15.6","4.2"
"District of Columbia","2009","474864","15523","3366","0.7","24.0","1836","9.3","1713","8.7","19694","936","939","5809","18703","41662","60365","12.7","3.9","43356","56999","13643","12.0","2.9"
"Florida","2009","6675773","339120","-452702","-6.7","25.4","48630","11.2","61236","14.1","426736","42645","42873","217397","366334","479233","845567","12.7","5.5","935747","1298269","362522","19.4","5.4"
"Geogia","2009","3484607","149668","-206915","-5.9","24.8","19402","9.7","24941","12.5","195693","17251","17357","110720","183760","247212","430972","12.4","5.3","455110","637887","182777","18.3","5.2"
"Hawaii","2009","497508","23197","-26227","-5.3","20.2","2413","8.1","2722","9.1","29631","1848","1852","10453","19860","30551","50411","10.1","4.0","57977","76638","18661","15.4","3.8"
"Idaho","2009","514604","31896","-35189","-6.8","22.2","3623","9.2","5315","13.4","38562","3463","3463","16011","23916","33209","57125","11.1","4.6","67070","92314","25244","17.9","4.9"
"Illinois","2009","5258092","219962","-307788","-5.9","20.6","24157","8.6","29069","10.3","279176","18307","18358","115899","204167","339684","543851","10.3","3.9","633815","851639","217824","16.2","4.1"
"Indiana","2009","2517770","100048","-150475","-5.9","21.4","10175","7.5","12758","9.5","133404","8376","8449","50973","91730","176663","268393","10.7","3.6","318964","418868","99904","16.6","4.0"
"Iowa","2009","1285871","56255","-28070","-2.2","21.8","5203","7.1","5908","8.0","73156","3982","3986","24510","44560","96028","140588","10.9","3.5","131350","168658","37308","13.1","2.9"
"Kansas","2009","1143428","53274","-30516","-2.7","22.0","5245","7.7","6080","8.9","67992","4163","4171","24629","41895","84159","126054","11.0","3.7","118791","156570","37779","13.7","3.3"
"Kentucky","2009","1507615","62735","-68308","-4.5","21.8","6671","8.0","7578","9.0","83313","5205","5229","30803","60790","103269","164059","10.9","4.0","178353","232367","54014","15.4","3.6"
"Louisiana","2009","1626084","73649","-9866","-0.6","26.0","7926","8.3","8085","8.5","94936","5698","5699","34714","71686","140011","211697","13.0","4.4","161246","221563","60317","13.6","3.7"
"Maine","2009","489262","28598","-18935","-3.8","20.6","2819","7.9","3763","10.5","35206","2378","2379","11482","17513","32781","50294","10.3","3.6","51554","69229","17675","14.1","3.6"
"Maryland","2009","2158142","95892","-85813","-4.0","22.6","10545","8.6","12771","10.4","121538","8212","8245","46629","86147","158771","244918","11.3","4.0","240578","330731","90153","15.3","4.2"
"Massachusetts","2009","2995655","121876","-102189","-3.4","20.6","12166","7.9","14787","9.5","153232","9322","9378","55799","105364","202549","307913","10.3","3.5","303936","410102","106166","13.7","3.5"
"Michigan","2009","3478306","153290","-231015","-6.7","23.0","15710","7.8","21855","10.9","197404","13799","13854","98250","144970","256280","401250","11.5","4.2","467633","632265","164632","18.2","4.7"
"Minnesota","2009","2442668","100846","-125026","-5.1","21.8","10732","8.3","12828","9.9","128178","7764","7804","52176","89141","176196","265337","10.9","3.6","301549","390363","88814","16.0","3.6"
"Mississippi","2009","916080","41861","-38808","-4.3","22.8","4471","8.1","5237","9.4","55013","3749","3767","22065","45076","59556","104632","11.4","4.9","105275","143440","38165","15.7","4.2"
"Missouri","2009","2401047","103325","-102852","-4.3","22.2","11423","8.4","14007","10.3","134648","9675","9693","59326","93957","172874","266831","11.1","3.9","265311","369683","104372","15.4","4.3"
"Montana","2009","346462","26670","-17307","-5.0","22.6","2763","8.7","3687","11.6","31254","2267","2267","8893","12305","26792","39097","11.3","3.6","41272","56404","15132","16.3","4.4"
"Nebraska","2009","786544","37043","-20596","-2.6","21.6","3631","7.8","3811","8.2","46618","2462","2469","14972","29063","55992","85055","10.8","3.7","75700","105651","29951","13.4","3.8"
"Nevada","2009","1091256","41072","-105988","-9.7","25.4","6517","12.3","7632","14.4","52478","5413","5445","35587","59324","79386","138710","12.7","5.4","187530","244698","57168","22.4","5.2"
"New Hampshire","2009","567450","27521","-24816","-4.4","20.6","2765","8.1","3579","10.4","33799","2326","2331","11749","18977","39693","58670","10.3","3.3","62070","83486","21416","14.7","3.8"
"New Jersey","2009","3492410","171218","-191743","-5.5","22.4","18642","8.9","24053","11.5","205730","16514","16552","93382","143706","248797","392503","11.2","4.1","423550","584246","160696","16.7","4.6"
"New Mexico","2009","621597","32272","-24671","-4.0","23.8","3562","8.7","4304","10.5","40705","2997","3001","15604","25829","48326","74155","11.9","4.2","72166","98826","26660","15.9","4.3"
"New York","2009","7462859","383366","-255497","-3.4","22.4","45488","9.9","48469","10.6","456158","33153","33219","176848","307453","527788","835241","11.2","4.1","799935","1090738","290803","14.6","3.9"
"North Carolina","2009","3449936","149439","-199959","-5.8","21.2","17508","8.7","21888","10.9","197716","15069","15121","80082","148087","218621","366708","10.6","4.3","423051","566667","143616","16.4","4.2"
"North Dakota","2009","291350","15624","-2051","-0.7","24.0","1505","7.8","1508","7.9","19170","957","958","7038","11912","23157","35069","12.0","4.1","25775","37120","11345","12.7","3.9"
"Ohio","2009","4564712","172788","-238212","-5.2","21.4","17359","7.3","22159","9.3","234803","14307","14499","100080","181103","305156","486259","10.7","4.0","537468","724471","187003","15.9","4.1"
"Oklahoma","2009","1295431","64651","-31183","-2.4","24.6","7298","8.9","7376","8.9","82358","5236","5245","35080","57140","101929","159069","12.3","4.4","132085","190252","58167","14.7","4.5"
"Oregon","2009","1414710","77779","-105256","-7.5","21.4","8699","8.8","11408","11.6","96649","7722","7734","34388","54402","97133","151535","10.7","3.8","195541","256791","61250","18.2","4.3"
"Pennsylvania","2009","5112881","208835","-173945","-3.4","20.6","20912","7.6","23435","8.5","273060","15000","15143","97546","177554","349169","526723","10.3","3.5","509788","700668","190880","13.7","3.7"
"Rhode Island","2009","420374","21652","-20376","-4.8","21.4","1978","7.6","2895","11.2","25369","1875","1876","12364","14222","30683","44905","10.7","3.4","45539","65281","19742","15.5","4.7"
"South Carolina","2009","1584474","71286","-101098","-6.4","22.0","8234","8.6","10485","11.0","93904","7269","7352","39164","74027","99863","173890","11.0","4.7","204428","274988","70560","17.4","4.5"
"South Dakota","2009","328010","18901","-4595","-1.4","23.4","1906","8.3","1994","8.7","22752","1330","1330","7702","13765","24639","38404","11.7","4.2","31076","42999","11923","13.1","3.6"
"Tennessee","2009","2386233","89911","-159916","-6.7","21.4","10414","8.4","12494","10.1","123069","8676","8719","58061","95798","159967","255765","10.7","4.0","316745","415681","98936","17.4","4.1"
"Texas","2009","8908457","348661","-242848","-2.7","27.2","47938","10.2","46739","9.9","471556","31994","32203","213008","478943","733767","1212710","13.6","5.4","1062608","1455558","392950","16.3","4.4"
"Utah","2009","1070249","48715","-47416","-4.5","26.4","6838","11.3","8466","14.0","59643","5711","5714","32281","50969","90808","141777","13.2","4.8","133063","189193","56130","17.7","5.2"
"Vermont","2009","267430","16258","-7200","-2.7","21.2","1527","7.9","1893","9.8","19070","1175","1181","5266","11153","17320","28473","10.6","4.2","25558","35673","10115","13.3","3.8"
"Virginia","2009","3068091","133184","-107285","-3.5","24.0","16294","9.2","18132","10.2","175757","12110","12138","66668","147830","221504","369334","12.0","4.8","350618","476619","126001","15.5","4.1"
"Washington","2009","2434700","126072","-122984","-5.1","25.4","15081","9.5","19196","12.0","156869","12846","12865","63786","100028","209907","309935","12.7","4.1","323049","432919","109870","17.8","4.5"
"West Virginia","2009","573846","27556","-7167","-1.2","23.4","2651","7.3","3038","8.3","36314","2159","2161","10657","22253","44792","67045","11.7","3.9","57187","74212","17025","12.9","3.0"
"Wisconsin","2009","2413196","98835","-113185","-4.6","18.4","9495","7.4","11599","9.0","127318","7519","7535","46369","73841","147007","220848","9.2","3.1","249292","334033","84741","13.8","3.5"
"Wyoming","2009","211114","15567","-6670","-3.1","26.8","1772","9.7","1831","10.0","18185","1255","1256","5876","9117","19097","28214","13.4","4.3","25300","34884","9584","16.5","4.5"
"Alabama","2010","1575651","68309","-37107","-2.4","22.4","7236","7.9","8278","9.0","91611","5861","5891","40694","61672","115251","176923","11.2","3.9","150626","214030","63404","13.6","4.0"
"Alaska","2010","249695","13381","2804","1.2","25.0","1648","9.8","1448","8.6","16841","841","849","4196","9272","24863","34135","13.7","3.7","23812","31331","7519","12.5","3.0"
"Arizona","2010","2056376","86469","-46116","-2.3","28.4","12266","10.6","13916","12.0","115033","9288","9345","54758","123771","168967","292738","14.2","6.0","237023","338854","101831","16.5","5.0"
"Arkansas","2010","959779","45330","-1543","-0.1","24.4","4956","8.4","5061","8.5","59242","3479","3482","21039","43056","73635","116691","12.2","4.5","85674","118234","32560","12.3","3.4"
"California","2010","12463214","591475","-340901","-2.7","25.0","74886","10.0","80810","10.8","747282","54251","54411","339689","581224","973388","1554612","12.5","4.7","1315287","1895513","580226","15.2","4.7"
"Colorado","2010","1940711","105043","-39849","-2.1","27.2","14136","10.8","15187","11.6","130161","9340","9352","50323","101267","162891","264158","13.6","5.2","212898","304007","91109","15.7","4.7"
"Connecticut","2010","1448532","64300","-23292","-1.6","21.4","6315","7.8","7009","8.7","80366","4509","4515","28282","51596","103558","155154","10.7","3.6","131057","178446","47389","12.3","3.3"
"Delaware","2010","362546","17005","-8796","-2.4","22.4","1905","8.8","2151","10.0","21470","1293","1293","6802","15812","24877","40689","11.2","4.4","34542","49485","14943","13.6","4.1"
"District of Columbia","2010","475054","15585","1335","0.3","23.8","1948","9.9","1618","8.2","19921","879","880","5860","19764","38075","57839","12.2","4.2","42977","56504","13527","11.9","2.8"
"Florida","2010","6402324","336332","-22258","-0.3","30.4","50482","11.9","51611","12.2","423077","34729","34794","190846","394858","576324","971182","15.2","6.2","667502","993440","325938","15.5","5.1"
"Geogia","2010","3334780","146487","-51808","-1.5","25.6","18983","9.8","21224","11.0","192051","13860","13897","86003","163902","261749","425651","12.8","4.9","328808","477459","148651","14.3","4.5"
"Hawaii","2010","478938","22764","-8960","-1.8","23.4","2321","7.9","2596","8.9","29173","1644","1645","11002","21209","34690","55899","11.7","4.4","45240","64859","19619","13.5","4.1"
"Idaho","2010","491316","31109","-7652","-1.6","26.6","3733","9.8","4318","11.3","37767","2761","2772","12104","23135","42355","65490","13.3","4.7","53120","73142","20022","14.9","4.1"
"Illinois","2010","5014064","216836","-128458","-2.5","22.0","24500","8.9","25964","9.4","275846","15636","15687","104173","196508","353636","550144","11.0","3.9","487244","678602","191358","13.5","3.8"
"Indiana","2010","2407414","98223","-44582","-1.9","22.4","9967","7.5","11004","8.3","131554","7121","7136","52199","82856","186936","269792","11.2","3.4","229296","314374","85078","13.1","3.5"
"Iowa","2010","1256675","55740","-20070","-1.6","20.4","5189","7.1","5224","7.2","72787","3324","3330","24860","39343","89303","128646","10.2","3.1","109710","148716","39006","11.8","3.1"
"Kansas","2010","1112150","52476","-24542","-2.2","21.6","5150","7.6","5507","8.2","67257","3639","3651","21631","39340","80232","119572","10.8","3.5","103905","144114","40209","13.0","3.6"
"Kentucky","2010","1455388","61703","-18782","-1.3","23.4","6557","7.9","7015","8.5","82367","4595","4604","31448","62695","108036","170731","11.7","4.3","138508","189513","51005","13.0","3.5"
"Louisiana","2010","1597064","73129","-34429","-2.2","23.2","7837","8.3","7619","8.1","94735","5180","5194","34842","66495","119144","185639","11.6","4.2","165794","220068","54274","13.8","3.4"
"Maine","2010","474718","28322","-6776","-1.4","21.8","3044","8.7","3098","8.8","35009","1854","1854","9039","19651","31892","51543","10.9","4.1","41396","58319","16923","12.3","3.6"
"Maryland","2010","2090295","94482","-41527","-2.0","23.6","10560","8.8","11543","9.6","119965","6976","7003","40165","83263","163611","246874","11.8","4.0","210236","288401","78165","13.8","3.7"
"Massachusetts","2010","2909517","120173","-27451","-0.9","22.8","12824","8.4","13164","8.7","151804","8183","8215","50162","109569","220839","330408","11.4","3.8","267868","357859","89991","12.3","3.1"
"Michigan","2010","3308320","149650","-72076","-2.2","24.2","15361","7.9","18291","9.4","193215","11572","11583","78427","130494","270218","400712","12.1","3.9","336148","472788","136640","14.3","4.1"
"Minnesota","2010","2362890","99643","-18747","-0.8","22.8","10649","8.4","11055","8.7","127073","6568","6569","42835","95094","175104","270198","11.4","4.0","202583","288945","86362","12.2","3.7"
"Mississippi","2010","882239","41317","-15753","-1.8","21.8","4407","8.1","4596","8.4","54554","3209","3216","18548","34658","61657","96315","10.9","3.9","83134","112068","28934","12.7","3.3"
"Missouri","2010","2310166","101878","-49848","-2.2","22.4","12186","9.1","12479","9.4","133147","8379","8403","47758","92617","166822","259439","11.2","4.0","230245","309287","79042","13.4","3.4"
"Montana","2010","335519","26282","-2244","-0.7","24.6","2804","9.0","3035","9.8","30891","1853","1853","7397","15389","26030","41419","12.3","4.6","32312","43663","11351","13.0","3.4"
"Nebraska","2010","769497","36994","-6899","-0.9","20.8","3674","7.9","3409","7.3","46715","2092","2105","11677","27158","53066","80224","10.4","3.5","67561","87123","19562","11.3","2.5"
"Nevada","2010","1013982","40049","-33622","-3.3","29.0","6350","12.3","6770","13.1","51504","4669","4676","32802","68698","77855","146553","14.5","6.8","130534","180175","49641","17.8","4.9"
"New Hampshire","2010","553824","27162","1737","0.3","24.6","2809","8.4","2944","8.8","33438","1924","1930","10615","22391","47580","69971","12.6","4.0","50258","68234","17976","12.3","3.2"
"New Jersey","2010","3352898","167736","-50552","-1.5","24.0","18711","9.2","21516","10.6","201598","13922","13952","81792","144497","257094","401591","12.0","4.3","305290","452143","146853","13.5","4.4"
"New Mexico","2010","600779","31456","-12525","-2.1","23.6","3349","8.3","3992","9.9","39840","2628","2629","13648","24024","46889","70913","11.8","4.0","61915","83438","21523","13.9","3.6"
"New York","2010","7283366","384271","-49845","-0.7","24.4","47571","10.4","44876","9.8","457218","30381","30422","174791","328215","558709","886924","12.2","4.5","646055","936769","290714","12.9","4.0"
"North Carolina","2010","3288940","147065","-73278","-2.3","24.4","18243","9.3","19561","10.0","195119","12322","12368","71388","153690","249147","402837","12.2","4.7","341981","476115","134134","14.5","4.1"
"North Dakota","2010","290680","15814","3486","1.2","21.6","1584","8.2","1308","6.8","19404","784","784","3998","10719","24071","34790","12.0","3.7","23594","31304","7710","10.8","2.7"
"Ohio","2010","4373318","168776","-85062","-1.9","22.0","17044","7.4","19230","8.3","230640","11890","11915","86081","166757","312362","479119","11.0","3.8","418198","564181","145983","12.9","3.3"
"Oklahoma","2010","1251827","63978","-40018","-3.2","22.8","6874","8.4","7061","8.6","81768","4800","4816","30769","58138","84276","142414","11.4","4.6","132555","182432","49877","14.6","4.0"
"Oregon","2010","1349219","76540","-8199","-0.6","26.4","9212","9.6","9585","10.0","95661","6188","6219","34799","59281","118334","177615","13.2","4.4","133238","185814","52576","13.8","3.9"
"Pennsylvania","2010","4969707","206047","-65388","-1.3","22.4","20746","7.7","21591","8.0","270631","13440","13456","103895","193819","362058","555877","11.2","3.9","439211","621265","182054","12.5","3.7"
"Rhode Island","2010","401793","21240","-12360","-3.1","21.2","2197","8.7","2382","9.5","25045","1550","1550","8554","16896","25605","42501","10.6","4.2","41526","54861","13335","13.7","3.3"
"South Carolina","2010","1502711","69779","-30749","-2.0","24.4","8144","8.8","9065","9.8","92474","6080","6125","34737","72804","110081","182885","12.2","4.8","158480","213634","55154","14.2","3.7"
"South Dakota","2010","322349","18888","-2650","-0.9","22.6","1870","8.2","1735","7.6","22818","1109","1109","7094","13077","23453","36530","11.3","4.1","28427","39180","10753","12.2","3.3"
"Tennessee","2010","2271366","88094","-37505","-1.7","23.8","10128","8.3","10980","9.0","121225","7468","7494","51605","93997","177243","271240","11.9","4.1","222392","308745","86353","13.6","3.8"
"Texas","2010","8701186","348248","-92659","-1.0","27.8","47216","10.0","43204","9.2","472374","29270","29348","214455","479146","727523","1206669","13.9","5.5","923606","1299328","375722","14.9","4.3"
"Utah","2010","1024126","48045","-35132","-3.4","25.4","6933","11.7","7209","12.2","58940","4662","4684","30049","51952","77772","129724","12.7","5.1","117487","164856","47369","16.1","4.6"
"Vermont","2010","262339","16094","-2194","-0.9","19.6","1482","7.8","1570","8.3","18929","961","967","4784","8709","17065","25774","9.8","3.3","20574","27968","7394","10.7","2.8"
"Virginia","2010","2972940","131474","-34768","-1.1","25.4","15688","9.0","16266","9.3","174051","10130","10160","62347","134071","242192","376263","12.7","4.5","285187","411031","125844","13.8","4.2"
"Washington","2010","2331154","124320","-64509","-2.7","23.8","15275","9.8","16049","10.3","155140","10454","10489","52036","108722","167704","276426","11.9","4.7","249190","340935","91745","14.6","3.9"
"West Virginia","2010","562235","26884","-11410","-2.0","22.8","2459","6.8","2831","7.9","35741","1885","1905","12372","21986","42111","64097","11.4","3.9","55576","75507","19931","13.4","3.5"
"Wisconsin","2010","2326373","97188","-38798","-1.7","19.8","9295","7.4","10021","7.9","125869","6366","6371","42665","76122","153820","229942","9.9","3.3","195072","268740","73668","11.6","3.2"
"Wyoming","2010","201268","15163","-8937","-4.4","23.2","1547","8.6","1815","10.1","17795","1158","1158","4821","8185","15166","23351","11.6","4.1","23770","32288","8518","16.0","4.2"
"Alabama","2011","1553149","67013","12407","0.8","23.2","7308","8.1","7951","8.8","90232","5369","5393","29016","64020","127830","191850","12.4","4.1","126182","179443","53261","11.6","3.4"
"Alaska","2011","251986","13339","674","0.3","24.6","1642","9.7","1492","8.8","16965","856","861","4102","10061","21615","31676","12.6","4.0","22582","31002","8420","12.3","3.3"
"Arizona","2011","2048945","85339","52262","2.5","25.8","12639","11.1","12809","11.2","114040","8445","8492","53681","106373","209645","316018","15.4","5.2","175038","263756","88718","12.9","4.3"
"Arkansas","2011","962552","44767","14295","1.5","22.8","5109","8.7","5139","8.7","58774","3510","3525","20023","41156","83067","124223","12.9","4.3","76229","109928","33699","11.4","3.5"
"California","2011","12340963","590584","221553","1.8","24.8","79745","10.7","74294","10.0","748458","49559","49745","307002","573390","1177698","1751088","14.2","4.6","998758","1529535","530777","12.4","4.3"
"Colorado","2011","1926868","104338","30667","1.6","25.8","14530","11.2","14018","10.8","129760","8734","8744","48221","94578","184631","279209","14.5","4.9","168093","248542","80449","12.9","4.2"
"Connecticut","2011","1437538","63236","9031","0.7","21.4","6281","7.9","6889","8.6","79287","4362","4370","23570","52051","111283","163334","11.4","3.6","105954","154303","48349","10.7","3.4"
"Delaware","2011","357296","16787","-334","-0.1","24.2","1920","9.0","2018","9.5","21191","1222","1222","6347","13549","29861","43410","12.1","3.8","29614","43744","14130","12.2","4.0"
"District of Columbia","2011","482205","15706","15284","3.1","19.8","1866","9.3","1482","7.4","20165","823","823","6430","18491","44416","62907","13.0","3.8","36189","47623","11434","9.9","2.4"
"Florida","2011","6460908","337537","145066","2.3","28.6","53493","12.6","49052","11.6","425180","33118","33209","190027","406432","664106","1070538","16.6","6.3","575990","925472","349482","14.3","5.4"
"Geogia","2011","3298519","144809","27450","0.8","26.2","19555","10.3","19705","10.3","190576","13020","13057","82720","155931","302138","458069","13.9","4.7","276185","430619","154434","13.1","4.7"
"Hawaii","2011","476669","22388","7435","1.5","21.2","2335","8.1","2390","8.3","28869","1623","1627","9448","19386","38454","57840","12.1","4.1","34435","50405","15970","10.6","3.4"
"Idaho","2011","483705","30134","-4430","-0.9","25.4","3581","9.6","4220","11.3","36806","2652","2660","13905","20350","40968","61318","12.7","4.2","44911","65748","20837","13.6","4.3"
"Illinois","2011","4969298","215800","80081","1.6","22.0","26068","9.5","24939","9.1","275240","15366","15544","95503","200466","425185","625651","12.6","4.0","378763","545570","166807","11.0","3.4"
"Indiana","2011","2398400","96669","44622","1.9","20.8","10642","8.2","10709","8.2","130392","7009","7043","46968","87223","207386","294609","12.3","3.6","173573","249987","76414","10.4","3.2"
"Iowa","2011","1252562","55092","20029","1.6","19.2","5346","7.4","5444","7.5","72304","3419","3428","19369","40358","100169","140527","11.2","3.2","87341","120498","33157","9.6","2.6"
"Kansas","2011","1096570","51402","-98","0.0","24.0","5444","8.2","5672","8.5","66564","3766","3768","22733","47391","84294","131685","12.0","4.3","93364","131783","38419","12.0","3.5"
"Kentucky","2011","1444962","60544","9292","0.7","22.8","6575","8.0","6802","8.3","81479","4683","4695","30695","54147","120134","174281","12.1","3.7","114297","164989","50692","11.4","3.5"
"Louisiana","2011","1587766","72574","22142","1.4","23.6","7994","8.5","7622","8.1","94665","5252","5268","30919","70584","138549","209133","13.2","4.4","134511","186991","52480","11.8","3.3"
"Maine","2011","469665","27836","969","0.2","22.2","2998","8.6","3235","9.3","34526","1903","1907","10301","18599","34586","53185","11.3","4.0","35232","52216","16984","11.1","3.6"
"Maryland","2011","2079515","93326","37318","1.8","22.6","10884","9.1","10646","8.9","119320","6781","6785","38022","90617","182477","273094","13.1","4.4","169548","235776","66228","11.3","3.2"
"Massachusetts","2011","2902293","119684","37819","1.3","20.2","13117","8.7","12237","8.1","151698","7624","7631","42670","96314","235214","331528","11.4","3.3","212505","293709","81204","10.1","2.8"
"Michigan","2011","3316652","148091","113051","3.5","22.0","16662","8.7","16624","8.6","192152","10566","10597","71827","126206","353217","479423","14.5","3.8","247524","366372","118848","11.0","3.6"
"Minnesota","2011","2373328","98958","51067","2.2","19.6","11038","8.7","10755","8.5","126765","6604","6623","42796","86391","197869","284260","12.0","3.6","162291","233193","70902","9.8","3.0"
"Mississippi","2011","875789","40741","8156","0.9","21.6","4370","8.1","4427","8.2","54116","3115","3121","17698","36121","66570","102691","11.7","4.1","65764","94535","28771","10.8","3.3"
"Missouri","2011","2279005","99809","6454","0.2","22.2","11952","9.1","12657","9.6","131606","8914","8920","47117","82304","176074","258378","11.3","3.6","177721","251924","74203","11.1","3.3"
"Montana","2011","332629","25815","-4261","-1.3","24.0","2883","9.4","3087","10.1","30437","1872","1881","11434","12554","27497","40051","12.0","3.8","28001","44312","16311","13.3","4.9"
"Nebraska","2011","759973","36588","-5412","-0.7","22.8","3788","8.1","3693","7.9","46481","2308","2314","13516","27090","59755","86845","11.4","3.6","59103","92257","33154","12.1","4.4"
"Nevada","2011","992737","39829","-1028","-0.1","26.8","6384","12.4","6084","11.9","51417","4235","4262","32216","46742","86581","133323","13.4","4.7","88435","134351","45916","13.5","4.6"
"New Hampshire","2011","548780","26731","-8193","-1.5","20.8","2685","8.1","2883","8.7","33030","1924","1924","11192","16970","40287","57257","10.4","3.1","47520","65450","17930","11.9","3.3"
"New Jersey","2011","3329964","166309","32669","1.0","23.8","19768","9.9","19913","9.9","200448","13313","13343","72524","141465","288123","429588","12.9","4.2","269976","396919","126943","11.9","3.8"
"New Mexico","2011","594037","31031","1291","0.2","24.0","3615","9.1","3622","9.1","39592","2456","2461","12203","24117","48188","72305","12.2","4.1","52241","71014","18773","12.0","3.2"
"New York","2011","7297157","385117","132180","1.8","22.6","48755","10.7","45135","9.9","459053","30479","30525","166997","321549","636775","958324","13.1","4.4","544978","826144","281166","11.3","3.9"
"North Carolina","2011","3264355","144978","66441","2.0","22.2","17930","9.3","18251","9.4","193170","12172","12248","70369","139388","288277","427665","13.1","4.3","249927","361224","111297","11.1","3.4"
"North Dakota","2011","295747","15966","8125","2.8","20.6","1856","9.5","1442","7.4","19700","926","928","5748","12781","25890","38671","13.1","4.3","21923","30546","8623","10.3","2.9"
"Ohio","2011","4357379","166689","92671","2.2","21.0","17683","7.7","18409","8.0","228282","11430","11490","78508","156176","395602","551778","12.7","3.6","325361","459107","133746","10.5","3.1"
"Oklahoma","2011","1238630","63234","23861","1.9","22.8","7173","8.8","7056","8.7","81323","4891","4905","28940","51579","113395","164974","13.3","4.2","95730","141113","45383","11.4","3.7"
"Oregon","2011","1333135","75853","3705","0.3","25.2","9196","9.7","9140","9.6","95050","5971","6015","29732","49739","121962","171701","12.9","3.7","119510","167996","48486","12.6","3.6"
"Pennsylvania","2011","4968181","204451","109043","2.2","20.6","21855","8.1","20298","7.5","270195","12955","12985","84518","197565","422680","620245","12.5","4.0","358222","511202","152980","10.3","3.1"
"Rhode Island","2011","399466","20958","10204","2.5","19.6","2177","8.8","2266","9.1","24814","1428","1431","6613","14790","34460","49250","12.3","3.7","26191","39046","12855","9.8","3.2"
"South Carolina","2011","1491568","68279","20451","1.4","24.0","7963","8.7","8667","9.5","91070","5869","5886","36245","64008","135127","199135","13.4","4.3","122372","178684","56312","12.0","3.8"
"South Dakota","2011","319150","18673","-1992","-0.6","23.2","1850","8.1","1854","8.2","22699","1193","1202","9527","13067","23975","37042","11.6","4.1","25587","39034","13447","12.2","4.2"
"Tennessee","2011","2261749","86652","41208","1.8","22.2","10255","8.5","10717","8.9","119647","7370","7436","46629","81799","210006","291805","12.9","3.6","167465","250597","83132","11.1","3.7"
"Texas","2011","8725992","348526","214002","2.5","25.2","49385","10.5","43344","9.2","475059","29737","29905","206349","455216","858942","1314158","15.1","5.2","763726","1100156","336430","12.6","3.9"
"Utah","2011","1010121","47970","13721","1.3","25.0","6945","11.8","6445","11.0","59067","4179","4198","26514","50588","89162","139750","13.8","5.0","85817","126029","40212","12.5","4.0"
"Vermont","2011","261283","15835","1599","0.6","19.8","1468","7.8","1674","8.9","18631","1044","1048","4666","7659","19688","27347","10.5","2.9","17859","25748","7889","9.9","3.0"
"Virginia","2011","2962845","129895","44874","1.5","24.2","16468","9.5","15775","9.1","173214","10228","10252","59331","134609","267853","402462","13.6","4.5","252368","357588","105220","12.1","3.6"
"Washington","2011","2283205","121993","-11316","-0.5","27.2","15335","10.0","16264","10.6","152946","10567","10586","52444","97893","212112","310005","13.6","4.3","208226","321321","113095","14.1","5.0"
"West Virginia","2011","555542","26243","5521","1.0","21.6","2621","7.4","2824","8.0","35267","1961","1962","11291","18403","47322","65725","11.8","3.3","43485","60204","16719","10.8","3.0"
"Wisconsin","2011","2316296","95468","35660","1.5","19.2","9224","7.4","10019","8.0","124286","6324","6361","38882","72295","184574","256869","11.1","3.1","158748","221209","62461","9.6","2.7"
"Wyoming","2011","198960","15218","3774","1.9","25.4","1799","10.1","1631","9.2","17900","1029","1029","4610","9200","19895","29095","14.6","4.6","17647","25321","7674","12.7","3.9"
"Alabama","2012","1560918","67040","15088","1.0","24.0","7896","8.8","7593","8.4","90410","4781","4835","30569","61103","141263","202366","13.0","3.9","129370","187278","57908","12.0","3.7"
"Alaska","2012","254120","13511","4320","1.7","27.8","1742","10.2","1618","9.5","17129","782","789","3692","12646","27092","39738","15.6","5.0","27178","35418","8240","13.9","3.2"
"Arizona","2012","2085298","85908","39919","1.9","27.8","12839","11.3","12008","10.5","114681","7236","7329","42669","110836","218716","329552","15.8","5.3","192419","289633","97214","13.9","4.7"
"Arkansas","2012","967495","44996","774","0.1","25.0","5117","8.7","4998","8.5","58976","3128","3166","18739","35285","86295","121580","12.6","3.6","83090","120806","37716","12.5","3.9"
"California","2012","12562400","600518","305292","2.4","25.4","84324","11.2","74867","10.0","758097","45546","45970","277550","593971","1308057","1902028","15.1","4.7","1049410","1596736","547326","12.7","4.4"
"Colorado","2012","1967362","105729","60210","3.1","24.2","14968","11.5","13521","10.4","131110","7756","7832","40588","99671","199470","299141","15.2","5.1","155969","238931","82962","12.1","4.2"
"Connecticut","2012","1459539","63690","40103","2.7","21.6","7075","8.9","6541","8.2","79786","3899","3929","22776","52856","144423","197279","13.5","3.6","108468","157176","48708","10.8","3.3"
"Delaware","2012","359730","16757","6503","1.8","25.2","2181","10.3","2031","9.6","21303","1151","1158","6259","18310","33536","51846","14.4","5.1","25956","45343","19387","12.6","5.4"
"District of Columbia","2012","489072","15848","10562","2.1","22.8","1791","8.9","1690","8.4","20144","823","835","6521","18326","47885","66211","13.5","3.7","40946","55649","14703","11.4","3.0"
"Florida","2012","6631502","347336","223327","3.3","27.0","55709","13.0","45371","10.6","435977","28696","29020","211495","381064","735804","1116868","16.8","5.7","522490","893541","371051","13.5","5.6"
"Geogia","2012","3330625","146087","66159","2.0","25.6","21132","11.1","19523","10.2","192068","11546","11651","68040","171518","321952","493470","14.8","5.1","273130","427311","154181","12.8","4.6"
"Hawaii","2012","485956","22387","12375","2.5","20.2","2351","8.2","2445","8.5","28754","1392","1401","7073","19637","41730","61367","12.6","4.0","32038","48992","16954","10.1","3.5"
"Idaho","2012","487577","30496","12119","2.5","25.6","3983","10.8","3744","10.1","37172","2228","2253","10421","26324","48230","74554","15.3","5.4","37094","62435","25341","12.8","5.2"
"Illinois","2012","5037329","217700","83338","1.6","23.8","26914","9.8","25193","9.1","276756","14126","14253","86068","207932","474435","682367","13.5","4.1","396697","599029","202332","11.9","4.0"
"Indiana","2012","2470343","97354","82149","3.3","21.4","11593","8.9","10838","8.3","131243","6269","6372","41382","103356","243714","347070","14.0","4.2","182470","264921","82451","10.7","3.3"
"Iowa","2012","1272154","55616","28551","2.3","20.4","6074","8.4","5396","7.4","73020","3116","3136","19102","43472","115243","158715","12.5","3.4","85198","130164","44966","10.2","3.5"
"Kansas","2012","1109227","51741","28117","2.6","22.2","5905","8.9","5610","8.4","66938","3264","3317","20085","51863","99657","151520","13.7","4.7","83341","123403","40062","11.1","3.6"
"Kentucky","2012","1465476","60938","39583","2.7","23.0","7250","8.9","6818","8.4","82047","4089","4127","23720","65803","141722","207525","14.2","4.5","116100","167942","51842","11.5","3.5"
"Louisiana","2012","1613352","73250","31015","1.9","24.8","8626","9.1","7772","8.2","95673","4707","4753","31822","69570","160707","230277","14.3","4.3","140608","199262","58654","12.4","3.6"
"Maine","2012","474236","27876","10178","2.2","22.4","3320","9.6","3196","9.3","34656","1818","1830","9451","19953","43431","63384","13.4","4.2","35423","53206","17783","11.2","3.7"
"Maryland","2012","2120412","94702","53471","2.5","23.6","11479","9.6","10190","8.5","120696","5840","5899","33511","95644","208525","304169","14.3","4.5","169935","250698","80763","11.8","3.8"
"Massachusetts","2012","2951346","121449","82945","2.9","20.0","14300","9.4","12519","8.2","153355","7176","7265","45369","102465","277046","379511","12.9","3.5","202314","296566","94252","10.0","3.2"
"Michigan","2012","3414408","149907","98103","2.9","24.0","17908","9.3","16422","8.5","193894","9349","9477","81485","146760","362597","509357","14.9","4.3","251722","411254","159532","12.0","4.7"
"Minnesota","2012","2428855","99812","70864","2.9","20.6","11563","9.1","10649","8.4","127577","5791","5865","41428","80423","240937","321360","13.2","3.3","170986","250496","79510","10.3","3.3"
"Mississippi","2012","883500","40654","9416","1.1","22.8","4482","8.3","4547","8.4","54240","2924","2940","15878","32522","77985","110507","12.5","3.7","72674","101091","28417","11.4","3.2"
"Missouri","2012","2298178","99998","45314","1.9","22.6","12941","9.8","12620","9.6","131820","8060","8147","40556","98084","205841","303925","13.2","4.3","178274","258611","80337","11.3","3.5"
"Montana","2012","334743","26311","8738","2.6","23.8","3323","10.8","2844","9.3","31009","1645","1661","6937","16537","32011","48548","14.5","4.9","26936","39810","12874","11.9","3.8"
"Nebraska","2012","767653","37168","23316","3.1","20.6","4059","8.7","3593","7.7","47067","2057","2088","11544","33148","69589","102737","13.4","4.3","57053","79421","22368","10.3","2.9"
"Nevada","2012","1005799","40292","32052","3.2","25.2","6486","12.6","5950","11.6","51834","3767","3817","26410","59107","99468","158575","15.8","5.9","78910","126523","47613","12.6","4.7"
"New Hampshire","2012","543887","26950","-3815","-0.7","24.0","3113","9.4","2841","8.6","33332","1718","1749","10978","20506","44729","65235","12.0","3.8","40321","69050","28729","12.7","5.3"
"New Jersey","2012","3369316","168215","59556","1.8","24.4","21240","10.6","19176","9.5","202368","12074","12153","63242","134059","337235","471294","14.0","4.0","276729","411738","135009","12.2","4.0"
"New Mexico","2012","592770","31183","2467","0.5","26.4","3821","9.6","3636","9.2","39776","2202","2262","11098","27808","53157","80965","13.7","4.7","53422","78498","25076","13.2","4.2"
"New York","2012","7441512","391663","191870","2.5","22.2","51047","11.0","43871","9.5","465996","28604","28796","148697","311589","702744","1014333","13.6","4.2","551821","822463","270642","11.1","3.6"
"North Carolina","2012","3326358","146425","92644","2.8","23.0","19306","10.0","17574","9.1","195059","10534","10616","63645","142018","334750","476768","14.3","4.3","259826","384124","124298","11.5","3.7"
"North Dakota","2012","311942","16787","24538","7.8","20.6","2386","11.8","1513","7.5","20683","944","954","6546","18974","37567","56541","18.1","6.1","21117","32003","10886","10.3","3.5"
"Ohio","2012","4447644","167489","126983","2.9","22.2","19471","8.5","18429","8.1","229141","10485","10608","78617","171479","450651","622130","14.0","3.9","331871","495147","163276","11.1","3.7"
"Oklahoma","2012","1266162","64261","38562","3.0","24.0","7971","9.7","6868","8.4","82595","4246","4284","25046","63397","126596","189993","15.0","5.0","102904","151431","48527","12.0","3.8"
"Oregon","2012","1348910","76776","32109","2.4","23.8","10035","10.5","9293","9.7","95825","5284","5326","26531","62149","130165","192314","14.3","4.6","107420","160205","52785","11.9","3.9"
"Pennsylvania","2012","5059873","206269","119691","2.3","21.8","22803","8.4","21119","7.8","271751","12306","12433","79417","201721","468142","669863","13.2","4.0","380333","550172","169839","10.9","3.4"
"Rhode Island","2012","405522","21068","3843","0.9","23.2","2363","9.5","2239","9.0","24912","1299","1311","6761","16426","34319","50745","12.5","4.1","32952","46902","13950","11.6","3.4"
"South Carolina","2012","1515443","68781","31767","2.1","23.6","8429","9.2","7938","8.7","91685","4815","4869","26541","64257","146351","210608","13.9","4.2","124209","178841","54632","11.8","3.6"
"South Dakota","2012","324280","18994","12601","3.9","20.2","2164","9.4","1845","8.1","23119","1125","1134","5390","15643","29668","45311","14.0","4.8","22410","32710","10300","10.1","3.2"
"Tennessee","2012","2307993","86957","61047","2.7","22.2","11049","9.2","10552","8.8","120249","6484","6532","39797","96938","220708","317646","13.8","4.2","171442","256599","85157","11.1","3.7"
"Texas","2012","9032122","357026","371220","4.1","24.4","53845","11.2","43515","9.1","485545","26777","27137","179303","493447","981692","1475139","16.3","5.5","733441","1103919","370478","12.2","4.1"
"Utah","2012","1037334","49094","42807","4.1","24.4","7496","12.6","6240","10.5","60359","3796","3847","26546","58194","110803","168997","16.3","5.6","82602","126190","43588","12.2","4.2"
"Vermont","2012","263455","15939","3780","1.5","25.4","1748","9.4","1609","8.6","18787","952","962","5210","9592","27728","37320","14.2","3.6","23994","33540","9546","12.7","3.6"
"Virginia","2012","3009713","131180","67215","2.2","25.8","16844","9.7","15559","9.0","174438","8951","9071","48808","133653","321847","455500","15.1","4.4","265692","388285","122593","12.9","4.1"
"Washington","2012","2295186","122980","43951","1.9","24.6","16452","10.7","15606","10.2","153935","9124","9210","44907","102272","223968","326240","14.2","4.5","193744","282289","88545","12.3","3.9"
"West Virginia","2012","564982","26246","14778","2.6","22.4","2760","7.8","2774","7.9","35296","1674","1702","9193","22702","55182","77884","13.8","4.0","42668","63106","20438","11.2","3.6"
"Wisconsin","2012","2349754","95700","40712","1.7","20.2","10408","8.4","10087","8.1","124623","5867","5935","35075","77435","200888","278323","11.8","3.3","165453","237611","72158","10.1","3.1"
"Wyoming","2012","203410","15471","6645","3.3","27.4","1923","10.7","1687","9.4","18185","1016","1043","4929","11269","23256","34525","17.0","5.5","17040","27880","10840","13.7","5.3"
"Alabama","2013","1578455","66905","25806","1.6","22.0","7072","7.9","7214","8.0","90227","4806","4824","32696","58278","140731","199009","12.6","3.7","115944","173203","57259","11.0","3.6"
"Alaska","2013","259981","13645","7623","3.0","20.8","1691","9.9","1553","9.0","17283","836","837","4401","9449","25299","34748","13.4","3.6","19467","27125","7658","10.4","2.9"
"Arizona","2013","2120586","86916","47036","2.2","23.8","12161","10.6","10954","9.5","115965","6918","6963","47037","96354","203003","299357","14.1","4.5","170811","252321","81510","11.9","3.8"
"Arkansas","2013","969813","45012","8343","0.9","22.2","4916","8.3","4852","8.2","59083","3278","3324","18667","36152","80011","116163","12.0","3.7","71677","107820","36143","11.1","3.7"
"California","2013","12944028","608395","526448","4.0","22.8","81236","10.7","73969","9.7","766124","46510","46788","295224","658867","1338260","1997127","15.4","5.1","957910","1470679","512769","11.4","4.0"
"Colorado","2013","2040954","107578","99827","4.8","23.0","14812","11.2","12914","9.8","133041","7841","7866","47206","96507","237116","333623","16.3","4.7","150761","233796","83035","11.5","4.1"
"Connecticut","2013","1486501","63598","20260","1.4","19.6","6565","8.3","6569","8.3","79762","3928","3955","25969","49151","117101","166252","11.2","3.3","100653","145992","45339","9.8","3.1"
"Delaware","2013","373356","16899","23701","6.3","20.2","2008","9.4","1815","8.5","21471","1088","1095","5799","23824","37429","61253","16.4","6.4","25738","37552","11814","10.1","3.2"
"District of Columbia","2013","496221","16060","9093","1.8","20.6","2017","10.0","1572","7.8","20517","849","853","8653","19815","40442","60257","12.1","4.0","33972","51164","17192","10.3","3.5"
"Florida","2013","6820517","355174","178366","2.7","24.8","52751","12.0","45746","10.4","444381","29482","29569","168779","360452","666914","1027366","15.1","5.3","546530","849000","302470","12.4","4.4"
"Geogia","2013","3383796","147556","77257","2.3","23.0","19387","10.1","17793","9.3","193563","11246","11277","75615","137800","328766","466566","13.8","4.1","250018","389309","139291","11.5","4.1"
"Hawaii","2013","495066","22478","9315","1.9","19.6","2318","8.1","2220","7.7","28843","1350","1357","9733","17647","40250","57897","11.7","3.6","30912","48582","17670","9.8","3.6"
"Idaho","2013","503402","30798","22298","4.4","20.4","3784","10.2","3564","9.6","37488","2251","2255","12170","23448","50193","73641","14.6","4.7","33485","51343","17858","10.2","3.5"
"Illinois","2013","5120985","218024","115573","2.2","21.6","25275","9.2","24720","9.0","277239","14651","14763","100278","212443","454510","666953","13.0","4.1","367716","551380","183664","10.8","3.6"
"Indiana","2013","2518862","96954","53310","2.1","20.2","9924","7.6","10353","7.9","130644","6514","6543","45883","86234","221091","307325","12.2","3.4","178623","254015","75392","10.1","3.0"
"Iowa","2013","1291407","55291","15845","1.3","18.6","5218","7.2","5272","7.2","72903","3249","3270","20245","41032","95416","136448","10.6","3.2","84182","120603","36421","9.3","2.8"
"Kansas","2013","1129544","51585","20903","1.9","20.8","5170","7.8","5271","7.9","66766","3416","3434","22133","41632","97183","138815","12.3","3.7","81905","117912","36007","10.4","3.2"
"Kentucky","2013","1487223","61239","17432","1.2","23.2","7015","8.6","6420","7.8","82512","4200","4216","29184","61543","128716","190259","12.8","4.1","114831","172827","57996","11.6","3.9"
"Louisiana","2013","1644516","73489","43942","2.7","22.2","7617","8.0","7455","7.8","95911","4869","4889","37746","65220","161414","226634","13.8","4.0","123526","182692","59166","11.1","3.6"
"Maine","2013","477017","27767","1389","0.3","22.2","2868","8.3","2971","8.6","34520","1725","1738","11172","17235","37079","54314","11.4","3.6","34067","52925","18858","11.1","4.0"
"Maryland","2013","2162804","95277","42094","2.0","22.4","11029","9.1","10147","8.4","121666","5998","6029","43516","98914","185959","284873","13.2","4.6","166825","242779","75954","11.2","3.5"
"Massachusetts","2013","3023432","122283","72064","2.4","18.6","13114","8.5","12214","8.0","154320","7211","7287","48670","106509","247306","353815","11.7","3.5","193874","281751","87877","9.3","2.9"
"Michigan","2013","3493413","150130","74838","2.1","21.0","15710","8.1","15922","8.2","193720","9677","9701","63954","127864","312297","440161","12.6","3.7","258108","365323","107215","10.5","3.1"
"Minnesota","2013","2480836","100081","37618","1.6","20.4","10581","8.3","10010","7.9","128130","5922","5928","43419","80118","211506","291624","11.8","3.2","185951","254006","68055","10.2","2.7"
"Mississippi","2013","889329","40653","8763","1.0","20.2","4073","7.5","4102","7.6","54222","2871","2891","17954","28103","70820","98923","11.1","3.2","65879","90160","24281","10.1","2.7"
"Missouri","2013","2336733","101482","47686","2.0","20.2","13048","9.9","11426","8.6","133391","7507","7562","41846","80437","202941","283378","12.1","3.4","162917","235692","72775","10.1","3.1"
"Montana","2013","344744","26602","13693","4.0","20.4","3099","10.0","2833","9.1","31322","1720","1727","7902","18202","30676","48878","14.2","5.3","23653","35185","11532","10.2","3.3"
"Nebraska","2013","778041","37230","2085","0.3","22.0","3717","7.9","3537","7.5","47252","2254","2264","13916","24617","62928","87545","11.3","3.2","60696","85460","24764","11.0","3.2"
"Nevada","2013","1029297","40954","21388","2.0","25.8","6350","12.2","5555","10.7","52566","3674","3719","29562","55777","97928","153705","14.9","5.4","85170","132317","47147","12.9","4.6"
"New Hampshire","2013","541506","26892","3097","0.5","21.8","2749","8.3","2728","8.2","33336","1722","1726","9901","18497","43450","61947","11.4","3.4","41545","58850","17305","10.9","3.2"
"New Jersey","2013","3427468","169057","65651","1.9","24.0","20074","9.9","19267","9.5","203522","12273","12329","80547","141598","336045","477643","13.9","4.1","270856","411992","141136","12.0","4.1"
"New Mexico","2013","594029","31114","4313","0.7","25.8","3398","8.6","3544","8.9","39680","2325","2347","14365","26180","54617","80797","13.6","4.4","52310","76484","24174","12.9","4.1"
"New York","2013","7601643","395139","155693","2.0","22.2","48036","10.3","45751","9.8","468881","28412","28584","163837","325921","671289","997210","13.1","4.3","555205","841517","286312","11.1","3.8"
"North Carolina","2013","3385642","147227","57872","1.7","23.0","18047","9.2","16736","8.6","196421","10898","10931","65858","142089","306400","448489","13.2","4.2","272040","390617","118577","11.5","3.5"
"North Dakota","2013","329645","17201","14843","4.5","22.4","2186","10.4","1626","7.8","21254","1079","1079","7822","16764","34924","51688","15.7","5.1","24091","36845","12754","11.2","3.9"
"Ohio","2013","4540054","166750","84539","1.9","21.4","17370","7.6","17332","7.6","228573","10639","10696","79921","154382","416186","570568","12.6","3.4","341469","486029","144560","10.7","3.2"
"Oklahoma","2013","1299486","64986","33282","2.6","22.0","7345","8.9","6585","8.0","83453","4417","4447","32804","56946","119792","176738","13.6","4.4","95420","143456","48036","11.0","3.7"
"Oregon","2013","1385753","77773","50474","3.7","20.4","9433","9.8","8215","8.5","96996","5241","5249","28033","56099","135835","191934","13.9","4.0","96989","141460","44471","10.2","3.2"
"Pennsylvania","2013","5126320","206131","31965","0.6","21.8","21418","7.9","20442","7.5","272479","12634","12678","97083","180455","409292","589747","11.5","3.5","399199","557782","158583","10.9","3.1"
"Rhode Island","2013","410711","20940","6879","1.6","19.6","2066","8.3","2172","8.7","24852","1326","1327","7621","12710","34229","46939","11.4","3.1","27119","40060","12941","9.8","3.2"
"South Carolina","2013","1543565","69262","39185","2.6","20.8","7916","8.7","7432","8.1","92043","4864","4911","27081","60986","139445","200431","13.0","4.0","114917","161246","46329","10.4","3.0"
"South Dakota","2013","331673","19097","3513","1.1","22.0","1805","7.8","1761","7.6","23223","1129","1129","7176","11552","28461","40013","12.1","3.5","23381","36500","13119","11.0","4.0"
"Tennessee","2013","2362705","87354","66115","2.8","21.8","10349","8.6","9741","8.1","120750","6436","6489","43979","92984","229622","322606","13.7","3.9","182161","256491","74330","10.9","3.1"
"Texas","2013","9351528","364402","324074","3.4","24.2","51051","10.4","42183","8.6","494516","27421","27572","206469","465621","987441","1453062","15.5","5.0","751526","1128988","377462","12.1","4.0"
"Utah","2013","1072434","50323","33568","3.2","24.2","7153","11.7","5891","9.7","61781","3572","3586","30590","56552","107102","163654","15.3","5.3","81562","130086","48524","12.1","4.5"
"Vermont","2013","261224","15853","-8079","-3.1","22.2","1384","7.4","1499","8.0","18684","923","923","15905","8778","20239","29017","11.1","3.4","18293","37096","18803","14.2","7.2"
"Virginia","2013","3059020","132186","58475","1.9","23.2","16361","9.4","14705","8.4","175936","8909","8936","55527","136552","276833","413385","13.5","4.5","254624","354910","100286","11.6","3.3"
"Washington","2013","2345646","124773","72804","3.1","21.6","16097","10.4","14374","9.3","155742","9111","9163","49550","103357","222030","325387","13.9","4.4","161541","252583","91042","10.8","3.9"
"West Virginia","2013","570133","25813","-1236","-0.2","23.0","2333","6.7","2773","7.9","34873","1776","1785","11409","19542","45819","65361","11.5","3.4","45457","66597","21140","11.7","3.7"
"Wisconsin","2013","2377451","95392","29763","1.2","19.0","9345","7.5","9497","7.7","124334","5763","5807","37824","69260","185455","254715","10.7","2.9","160483","224952","64469","9.5","2.7"
"Wyoming","2013","208589","15429","3748","1.8","25.6","1690","9.3","1715","9.5","18193","1128","1131","5881","9739","20804","30543","14.6","4.7","17797","26795","8998","12.8","4.3"
